GEO_ID,NAME,Population for whom poverty status is determined,Population for whom poverty status is determined!!AGE!!Under 18 years,Population for whom poverty status is determined!!AGE!!Under 18 years!!Under 5 years,Population for whom poverty status is determined!!AGE!!Under 18 years!!5 to 17 years
860Z200US06390,ZCTA5 06390,53,6,0,6
860Z200US10001,ZCTA5 10001,25825,2675,744,1931
860Z200US10002,ZCTA5 10002,75806,10022,2141,7881
860Z200US10003,ZCTA5 10003,44602,3580,1404,2176
860Z200US10004,ZCTA5 10004,4578,839,432,407
860Z200US10005,ZCTA5 10005,8801,924,484,440
860Z200US10006,ZCTA5 10006,3736,319,128,191
860Z200US10007,ZCTA5 10007,7005,1534,605,929
860Z200US10009,ZCTA5 10009,58348,6085,1863,4222
860Z200US10010,ZCTA5 10010,30193,4369,1414,2955
860Z200US10011,ZCTA5 10011,48929,4699,1202,3497
860Z200US10012,ZCTA5 10012,20294,1506,606,900
860Z200US10013,ZCTA5 10013,27447,4127,1248,2879
860Z200US10014,ZCTA5 10014,29104,2173,708,1465
860Z200US10016,ZCTA5 10016,53101,4744,1740,3004
860Z200US10017,ZCTA5 10017,14447,608,193,415
860Z200US10018,ZCTA5 10018,8657,655,240,415
860Z200US10019,ZCTA5 10019,42643,2759,1099,1660
860Z200US10020,ZCTA5 10020,0,0,0,0
860Z200US10021,ZCTA5 10021,40112,6405,1783,4622
860Z200US10022,ZCTA5 10022,33224,3541,1228,2313
860Z200US10023,ZCTA5 10023,63861,9224,3537,5687
860Z200US10024,ZCTA5 10024,62049,11019,4221,6798
860Z200US10025,ZCTA5 10025,92591,14147,4452,9695
860Z200US10026,ZCTA5 10026,38141,7414,2185,5229
860Z200US10027,ZCTA5 10027,58439,11682,3603,8079
860Z200US10028,ZCTA5 10028,45697,6297,1718,4579
860Z200US10029,ZCTA5 10029,73401,13503,3925,9578
860Z200US10030,ZCTA5 10030,31144,5695,1820,3875
860Z200US10031,ZCTA5 10031,60781,9021,2328,6693
860Z200US10032,ZCTA5 10032,59137,8043,2085,5958
860Z200US10033,ZCTA5 10033,57909,9835,3112,6723
860Z200US10034,ZCTA5 10034,41494,7992,2556,5436
860Z200US10035,ZCTA5 10035,37632,8057,2372,5685
860Z200US10036,ZCTA5 10036,30687,1943,579,1364
860Z200US10037,ZCTA5 10037,18899,3488,1063,2425
860Z200US10038,ZCTA5 10038,22151,3122,772,2350
860Z200US10039,ZCTA5 10039,29885,6562,1898,4664
860Z200US10040,ZCTA5 10040,42632,7544,1917,5627
860Z200US10044,ZCTA5 10044,10990,2178,939,1239
860Z200US10065,ZCTA5 10065,30702,5122,2226,2896
860Z200US10069,ZCTA5 10069,6259,1558,690,868
860Z200US10075,ZCTA5 10075,23450,3660,1243,2417
860Z200US10103,ZCTA5 10103,0,0,0,0
860Z200US10110,ZCTA5 10110,0,0,0,0
860Z200US10111,ZCTA5 10111,0,0,0,0
860Z200US10112,ZCTA5 10112,0,0,0,0
860Z200US10115,ZCTA5 10115,0,0,0,0
860Z200US10119,ZCTA5 10119,0,0,0,0
860Z200US10128,ZCTA5 10128,56425,7684,2791,4893
860Z200US10152,ZCTA5 10152,0,0,0,0
860Z200US10153,ZCTA5 10153,0,0,0,0
860Z200US10154,ZCTA5 10154,0,0,0,0
860Z200US10162,ZCTA5 10162,1523,205,134,71
860Z200US10165,ZCTA5 10165,0,0,0,0
860Z200US10167,ZCTA5 10167,0,0,0,0
860Z200US10168,ZCTA5 10168,0,0,0,0
860Z200US10169,ZCTA5 10169,0,0,0,0
860Z200US10170,ZCTA5 10170,0,0,0,0
860Z200US10171,ZCTA5 10171,0,0,0,0
860Z200US10172,ZCTA5 10172,0,0,0,0
860Z200US10173,ZCTA5 10173,0,0,0,0
860Z200US10174,ZCTA5 10174,0,0,0,0
860Z200US10177,ZCTA5 10177,0,0,0,0
860Z200US10199,ZCTA5 10199,0,0,0,0
860Z200US10271,ZCTA5 10271,0,0,0,0
860Z200US10278,ZCTA5 10278,0,0,0,0
860Z200US10279,ZCTA5 10279,161,0,0,0
860Z200US10280,ZCTA5 10280,8843,1030,318,712
860Z200US10282,ZCTA5 10282,6450,1825,418,1407
860Z200US10301,ZCTA5 10301,39083,8245,2765,5480
860Z200US10302,ZCTA5 10302,18507,4359,1338,3021
860Z200US10303,ZCTA5 10303,27027,6417,1241,5176
860Z200US10304,ZCTA5 10304,43509,9581,2114,7467
860Z200US10305,ZCTA5 10305,41733,7427,1640,5787
860Z200US10306,ZCTA5 10306,55764,11897,2553,9344
860Z200US10307,ZCTA5 10307,14750,3337,1098,2239
860Z200US10308,ZCTA5 10308,30066,5941,1097,4844
860Z200US10309,ZCTA5 10309,34610,7880,1936,5944
860Z200US10310,ZCTA5 10310,26101,6626,2110,4516
860Z200US10311,ZCTA5 10311,0,0,0,0
860Z200US10312,ZCTA5 10312,63432,13990,3652,10338
860Z200US10314,ZCTA5 10314,93267,19941,5150,14791
860Z200US10451,ZCTA5 10451,51212,12548,3465,9083
860Z200US10452,ZCTA5 10452,77687,20661,5089,15572
860Z200US10453,ZCTA5 10453,79584,21036,5369,15667
860Z200US10454,ZCTA5 10454,40739,10611,2694,7917
860Z200US10455,ZCTA5 10455,44157,12253,2395,9858
860Z200US10456,ZCTA5 10456,87319,23652,6669,16983
860Z200US10457,ZCTA5 10457,78779,22798,6514,16284
860Z200US10458,ZCTA5 10458,79391,20942,5549,15393
860Z200US10459,ZCTA5 10459,51421,13277,3646,9631
860Z200US10460,ZCTA5 10460,59328,15185,3765,11420
860Z200US10461,ZCTA5 10461,49694,10831,2714,8117
860Z200US10462,ZCTA5 10462,76673,17941,5390,12551
860Z200US10463,ZCTA5 10463,68142,15197,4428,10769
860Z200US10464,ZCTA5 10464,4292,643,75,568
860Z200US10465,ZCTA5 10465,44270,9976,3165,6811
860Z200US10466,ZCTA5 10466,71475,16488,4275,12213
860Z200US10467,ZCTA5 10467,97118,22906,6230,16676
860Z200US10468,ZCTA5 10468,80123,21057,6560,14497
860Z200US10469,ZCTA5 10469,69522,15615,4295,11320
860Z200US10470,ZCTA5 10470,15299,2552,1276,1276
860Z200US10471,ZCTA5 10471,19987,3821,1011,2810
860Z200US10472,ZCTA5 10472,64796,16701,5182,11519
860Z200US10473,ZCTA5 10473,59182,12906,3429,9477
860Z200US10474,ZCTA5 10474,10617,3152,930,2222
860Z200US10475,ZCTA5 10475,42315,8268,2961,5307
860Z200US10501,ZCTA5 10501,1416,215,16,199
860Z200US10502,ZCTA5 10502,5725,1569,317,1252
860Z200US10503,ZCTA5 10503,94,0,0,0
860Z200US10504,ZCTA5 10504,7990,2118,521,1597
860Z200US10505,ZCTA5 10505,1132,251,44,207
860Z200US10506,ZCTA5 10506,6333,1714,316,1398
860Z200US10507,ZCTA5 10507,5428,1388,425,963
860Z200US10509,ZCTA5 10509,19671,4132,1103,3029
860Z200US10510,ZCTA5 10510,10198,2138,375,1763
860Z200US10511,ZCTA5 10511,2281,445,119,326
860Z200US10512,ZCTA5 10512,24115,4497,1127,3370
860Z200US10514,ZCTA5 10514,12867,3793,732,3061
860Z200US10516,ZCTA5 10516,5571,1097,280,817
860Z200US10517,ZCTA5 10517,417,26,11,15
860Z200US10518,ZCTA5 10518,830,133,11,122
860Z200US10519,ZCTA5 10519,122,79,0,79
860Z200US10520,ZCTA5 10520,12358,2684,618,2066
860Z200US10522,ZCTA5 10522,10679,2527,592,1935
860Z200US10523,ZCTA5 10523,9343,2018,671,1347
860Z200US10524,ZCTA5 10524,4334,806,131,675
860Z200US10526,ZCTA5 10526,1939,456,81,375
860Z200US10527,ZCTA5 10527,608,150,15,135
860Z200US10528,ZCTA5 10528,13305,3502,786,2716
860Z200US10530,ZCTA5 10530,14039,2163,835,1328
860Z200US10532,ZCTA5 10532,4907,913,289,624
860Z200US10533,ZCTA5 10533,7370,2230,538,1692
860Z200US10535,ZCTA5 10535,214,13,7,6
860Z200US10536,ZCTA5 10536,10399,2622,515,2107
860Z200US10537,ZCTA5 10537,2961,665,100,565
860Z200US10538,ZCTA5 10538,17564,5189,1213,3976
860Z200US10540,ZCTA5 10540,19,10,0,10
860Z200US10541,ZCTA5 10541,25932,5297,1299,3998
860Z200US10542,ZCTA5 10542,0,0,0,0
860Z200US10543,ZCTA5 10543,21020,4830,1142,3688
860Z200US10545,ZCTA5 10545,195,0,0,0
860Z200US10546,ZCTA5 10546,1022,187,47,140
860Z200US10547,ZCTA5 10547,7558,1585,370,1215
860Z200US10548,ZCTA5 10548,4101,715,221,494
860Z200US10549,ZCTA5 10549,15781,3526,1395,2131
860Z200US10550,ZCTA5 10550,39528,8254,1897,6357
860Z200US10552,ZCTA5 10552,21701,3677,1033,2644
860Z200US10553,ZCTA5 10553,10526,1747,438,1309
860Z200US10560,ZCTA5 10560,4765,1150,383,767
860Z200US10562,ZCTA5 10562,31673,6203,1701,4502
860Z200US10566,ZCTA5 10566,25267,4173,1040,3133
860Z200US10567,ZCTA5 10567,19664,4143,1127,3016
860Z200US10570,ZCTA5 10570,12180,2873,647,2226
860Z200US10573,ZCTA5 10573,40905,8577,2220,6357
860Z200US10576,ZCTA5 10576,4914,779,98,681
860Z200US10577,ZCTA5 10577,2916,683,212,471
860Z200US10578,ZCTA5 10578,1788,550,28,522
860Z200US10579,ZCTA5 10579,8171,1604,199,1405
860Z200US10580,ZCTA5 10580,17907,5228,765,4463
860Z200US10583,ZCTA5 10583,40993,11129,2179,8950
860Z200US10588,ZCTA5 10588,3295,822,322,500
860Z200US10589,ZCTA5 10589,7088,937,134,803
860Z200US10590,ZCTA5 10590,7406,1699,324,1375
860Z200US10591,ZCTA5 10591,23635,4637,1313,3324
860Z200US10594,ZCTA5 10594,5540,1254,359,895
860Z200US10595,ZCTA5 10595,6020,991,356,635
860Z200US10596,ZCTA5 10596,796,78,14,64
860Z200US10597,ZCTA5 10597,642,162,8,154
860Z200US10598,ZCTA5 10598,29031,5888,1247,4641
860Z200US10601,ZCTA5 10601,11001,1544,330,1214
860Z200US10603,ZCTA5 10603,19118,3796,1155,2641
860Z200US10604,ZCTA5 10604,11699,3215,707,2508
860Z200US10605,ZCTA5 10605,19634,3428,979,2449
860Z200US10606,ZCTA5 10606,16127,3318,910,2408
860Z200US10607,ZCTA5 10607,6557,1034,256,778
860Z200US10701,ZCTA5 10701,67363,15804,4635,11169
860Z200US10703,ZCTA5 10703,23298,4880,1232,3648
860Z200US10704,ZCTA5 10704,32412,6279,1849,4430
860Z200US10705,ZCTA5 10705,38708,8349,1898,6451
860Z200US10706,ZCTA5 10706,8806,1835,407,1428
860Z200US10707,ZCTA5 10707,10097,1993,715,1278
860Z200US10708,ZCTA5 10708,21087,4006,1110,2896
860Z200US10709,ZCTA5 10709,10085,2376,485,1891
860Z200US10710,ZCTA5 10710,26017,4836,1211,3625
860Z200US10801,ZCTA5 10801,39942,8310,1839,6471
860Z200US10803,ZCTA5 10803,13283,4016,656,3360
860Z200US10804,ZCTA5 10804,15018,3969,664,3305
860Z200US10805,ZCTA5 10805,19775,3225,1144,2081
860Z200US10901,ZCTA5 10901,25164,6183,1275,4908
860Z200US10910,ZCTA5 10910,0,0,0,0
860Z200US10911,ZCTA5 10911,12,0,0,0
860Z200US10913,ZCTA5 10913,4759,958,126,832
860Z200US10914,ZCTA5 10914,384,185,0,185
860Z200US10915,ZCTA5 10915,0,0,0,0
860Z200US10916,ZCTA5 10916,4350,1036,154,882
860Z200US10917,ZCTA5 10917,1969,592,295,297
860Z200US10918,ZCTA5 10918,11860,2296,646,1650
860Z200US10919,ZCTA5 10919,1256,216,23,193
860Z200US10920,ZCTA5 10920,8605,1860,389,1471
860Z200US10921,ZCTA5 10921,4263,884,222,662
860Z200US10922,ZCTA5 10922,1289,245,176,69
860Z200US10923,ZCTA5 10923,8326,2285,818,1467
860Z200US10924,ZCTA5 10924,12964,2711,730,1981
860Z200US10925,ZCTA5 10925,4466,857,160,697
860Z200US10926,ZCTA5 10926,3893,1014,242,772
860Z200US10927,ZCTA5 10927,12126,3007,1057,1950
860Z200US10928,ZCTA5 10928,5208,1076,222,854
860Z200US10930,ZCTA5 10930,10307,2182,323,1859
860Z200US10931,ZCTA5 10931,1131,370,133,237
860Z200US10932,ZCTA5 10932,43,0,0,0
860Z200US10933,ZCTA5 10933,401,175,42,133
860Z200US10940,ZCTA5 10940,51132,12107,3216,8891
860Z200US10941,ZCTA5 10941,14481,2781,638,2143
860Z200US10950,ZCTA5 10950,62369,26932,8478,18454
860Z200US10952,ZCTA5 10952,47338,21696,7131,14565
860Z200US10953,ZCTA5 10953,0,0,0,0
860Z200US10954,ZCTA5 10954,27161,5319,1382,3937
860Z200US10956,ZCTA5 10956,30420,6556,1619,4937
860Z200US10958,ZCTA5 10958,2516,579,92,487
860Z200US10960,ZCTA5 10960,13559,2342,618,1724
860Z200US10962,ZCTA5 10962,4972,886,171,715
860Z200US10963,ZCTA5 10963,3285,807,185,622
860Z200US10964,ZCTA5 10964,1525,222,21,201
860Z200US10965,ZCTA5 10965,15638,3718,984,2734
860Z200US10968,ZCTA5 10968,2473,332,167,165
860Z200US10969,ZCTA5 10969,999,329,102,227
860Z200US10970,ZCTA5 10970,11564,2927,1218,1709
860Z200US10973,ZCTA5 10973,2388,585,33,552
860Z200US10974,ZCTA5 10974,3283,657,208,449
860Z200US10975,ZCTA5 10975,246,76,0,76
860Z200US10976,ZCTA5 10976,1562,261,25,236
860Z200US10977,ZCTA5 10977,69893,28694,8346,20348
860Z200US10979,ZCTA5 10979,0,0,0,0
860Z200US10980,ZCTA5 10980,13702,2796,771,2025
860Z200US10983,ZCTA5 10983,5649,972,166,806
860Z200US10984,ZCTA5 10984,3079,616,298,318
860Z200US10985,ZCTA5 10985,42,6,6,0
860Z200US10986,ZCTA5 10986,1529,217,44,173
860Z200US10987,ZCTA5 10987,3764,573,122,451
860Z200US10988,ZCTA5 10988,683,172,66,106
860Z200US10989,ZCTA5 10989,8450,1317,284,1033
860Z200US10990,ZCTA5 10990,20374,3937,712,3225
860Z200US10992,ZCTA5 10992,10279,2617,584,2033
860Z200US10993,ZCTA5 10993,4687,623,37,586
860Z200US10994,ZCTA5 10994,6357,1331,279,1052
860Z200US10996,ZCTA5 10996,3964,1725,526,1199
860Z200US10998,ZCTA5 10998,3505,861,215,646
860Z200US11001,ZCTA5 11001,26097,5435,1111,4324
860Z200US11003,ZCTA5 11003,47343,8894,2563,6331
860Z200US11004,ZCTA5 11004,15047,2760,893,1867
860Z200US11005,ZCTA5 11005,2175,0,0,0
860Z200US11010,ZCTA5 11010,25607,5309,1455,3854
860Z200US11020,ZCTA5 11020,6145,1266,182,1084
860Z200US11021,ZCTA5 11021,19309,3890,937,2953
860Z200US11023,ZCTA5 11023,9677,3163,744,2419
860Z200US11024,ZCTA5 11024,8401,2931,801,2130
860Z200US11030,ZCTA5 11030,16961,4459,718,3741
860Z200US11040,ZCTA5 11040,42132,8168,1941,6227
860Z200US11042,ZCTA5 11042,0,0,0,0
860Z200US11050,ZCTA5 11050,31580,7757,1928,5829
860Z200US11096,ZCTA5 11096,9479,2498,827,1671
860Z200US11101,ZCTA5 11101,33955,4939,2086,2853
860Z200US11102,ZCTA5 11102,26744,3684,1307,2377
860Z200US11103,ZCTA5 11103,34685,4273,1489,2784
860Z200US11104,ZCTA5 11104,26859,4602,1711,2891
860Z200US11105,ZCTA5 11105,38734,5975,2082,3893
860Z200US11106,ZCTA5 11106,40088,5878,1893,3985
860Z200US11109,ZCTA5 11109,7280,1484,878,606
860Z200US11201,ZCTA5 11201,66258,11898,4803,7095
860Z200US11203,ZCTA5 11203,76922,14496,3932,10564
860Z200US11204,ZCTA5 11204,80303,23927,7070,16857
860Z200US11205,ZCTA5 11205,48525,15319,4722,10597
860Z200US11206,ZCTA5 11206,89645,24394,7051,17343
860Z200US11207,ZCTA5 11207,95955,21431,6145,15286
860Z200US11208,ZCTA5 11208,107287,28069,7846,20223
860Z200US11209,ZCTA5 11209,71410,13969,4161,9808
860Z200US11210,ZCTA5 11210,63077,14669,3465,11204
860Z200US11211,ZCTA5 11211,65345,13785,4905,8880
860Z200US11212,ZCTA5 11212,82950,19002,5764,13238
860Z200US11213,ZCTA5 11213,68131,16088,4799,11289
860Z200US11214,ZCTA5 11214,89911,19208,5128,14080
860Z200US11215,ZCTA5 11215,71466,15749,5519,10230
860Z200US11216,ZCTA5 11216,62041,9474,3035,6439
860Z200US11217,ZCTA5 11217,42513,8053,3650,4403
860Z200US11218,ZCTA5 11218,72552,18940,4733,14207
860Z200US11219,ZCTA5 11219,91303,35648,12042,23606
860Z200US11220,ZCTA5 11220,92454,23129,5639,17490
860Z200US11221,ZCTA5 11221,90920,15673,4600,11073
860Z200US11222,ZCTA5 11222,39965,4943,2386,2557
860Z200US11223,ZCTA5 11223,79782,21232,6569,14663
860Z200US11224,ZCTA5 11224,46805,9181,2133,7048
860Z200US11225,ZCTA5 11225,58470,9789,3053,6736
860Z200US11226,ZCTA5 11226,100579,18840,5553,13287
860Z200US11228,ZCTA5 11228,43949,8043,2232,5811
860Z200US11229,ZCTA5 11229,80842,17816,4749,13067
860Z200US11230,ZCTA5 11230,89746,24458,7822,16636
860Z200US11231,ZCTA5 11231,38798,8951,3167,5784
860Z200US11232,ZCTA5 11232,26150,5299,1493,3806
860Z200US11233,ZCTA5 11233,82547,17009,5622,11387
860Z200US11234,ZCTA5 11234,89789,19176,4664,14512
860Z200US11235,ZCTA5 11235,82021,14031,4278,9753
860Z200US11236,ZCTA5 11236,99182,21531,5669,15862
860Z200US11237,ZCTA5 11237,47043,7360,1992,5368
860Z200US11238,ZCTA5 11238,57559,9753,4394,5359
860Z200US11239,ZCTA5 11239,16681,3173,487,2686
860Z200US11249,ZCTA5 11249,44910,12952,4774,8178
860Z200US11354,ZCTA5 11354,51695,7169,2423,4746
860Z200US11355,ZCTA5 11355,79123,12426,3772,8654
860Z200US11356,ZCTA5 11356,27594,6313,2048,4265
860Z200US11357,ZCTA5 11357,42450,8526,2143,6383
860Z200US11358,ZCTA5 11358,37552,6893,2022,4871
860Z200US11359,ZCTA5 11359,0,0,0,0
860Z200US11360,ZCTA5 11360,19636,2806,827,1979
860Z200US11361,ZCTA5 11361,28963,5199,1411,3788
860Z200US11362,ZCTA5 11362,18278,2772,626,2146
860Z200US11363,ZCTA5 11363,7365,1564,334,1230
860Z200US11364,ZCTA5 11364,38030,7861,1867,5994
860Z200US11365,ZCTA5 11365,46375,10008,2904,7104
860Z200US11366,ZCTA5 11366,13536,2528,830,1698
860Z200US11367,ZCTA5 11367,42084,10590,3809,6781
860Z200US11368,ZCTA5 11368,110781,26379,7283,19096
860Z200US11369,ZCTA5 11369,31340,6076,1300,4776
860Z200US11370,ZCTA5 11370,23537,4290,1212,3078
860Z200US11371,ZCTA5 11371,0,0,0,0
860Z200US11372,ZCTA5 11372,66465,12555,3802,8753
860Z200US11373,ZCTA5 11373,101697,21348,5333,16015
860Z200US11374,ZCTA5 11374,46994,8637,2572,6065
860Z200US11375,ZCTA5 11375,74775,13497,4319,9178
860Z200US11377,ZCTA5 11377,86354,16149,5066,11083
860Z200US11378,ZCTA5 11378,38905,8459,2285,6174
860Z200US11379,ZCTA5 11379,37811,7367,1648,5719
860Z200US11385,ZCTA5 11385,105325,20780,5976,14804
860Z200US11411,ZCTA5 11411,21178,3345,838,2507
860Z200US11412,ZCTA5 11412,40445,7801,2093,5708
860Z200US11413,ZCTA5 11413,44521,8882,2051,6831
860Z200US11414,ZCTA5 11414,30370,6595,2164,4431
860Z200US11415,ZCTA5 11415,20202,3626,1153,2473
860Z200US11416,ZCTA5 11416,27528,6080,1717,4363
860Z200US11417,ZCTA5 11417,31094,7322,1993,5329
860Z200US11418,ZCTA5 11418,37780,8298,2324,5974
860Z200US11419,ZCTA5 11419,47849,7988,1868,6120
860Z200US11420,ZCTA5 11420,51023,9053,2427,6626
860Z200US11421,ZCTA5 11421,41472,8507,2369,6138
860Z200US11422,ZCTA5 11422,32133,5977,1258,4719
860Z200US11423,ZCTA5 11423,29493,5229,1231,3998
860Z200US11424,ZCTA5 11424,0,0,0,0
860Z200US11426,ZCTA5 11426,19667,3405,1244,2161
860Z200US11427,ZCTA5 11427,24848,4982,1840,3142
860Z200US11428,ZCTA5 11428,19393,3039,816,2223
860Z200US11429,ZCTA5 11429,27552,4716,982,3734
860Z200US11430,ZCTA5 11430,257,0,0,0
860Z200US11432,ZCTA5 11432,62633,13004,3934,9070
860Z200US11433,ZCTA5 11433,38537,9280,2793,6487
860Z200US11434,ZCTA5 11434,67088,14769,3925,10844
860Z200US11435,ZCTA5 11435,59312,12942,4654,8288
860Z200US11436,ZCTA5 11436,21165,4119,863,3256
860Z200US11439,ZCTA5 11439,0,0,0,0
860Z200US11451,ZCTA5 11451,0,0,0,0
860Z200US11501,ZCTA5 11501,21162,3524,986,2538
860Z200US11507,ZCTA5 11507,7111,1317,255,1062
860Z200US11509,ZCTA5 11509,1682,275,40,235
860Z200US11510,ZCTA5 11510,34993,7041,1595,5446
860Z200US11514,ZCTA5 11514,5040,1456,286,1170
860Z200US11516,ZCTA5 11516,8450,2383,430,1953
860Z200US11518,ZCTA5 11518,10219,2101,515,1586
860Z200US11520,ZCTA5 11520,44512,9282,2372,6910
860Z200US11530,ZCTA5 11530,27223,6830,1346,5484
860Z200US11542,ZCTA5 11542,28497,5386,1375,4011
860Z200US11545,ZCTA5 11545,12051,2746,367,2379
860Z200US11547,ZCTA5 11547,585,107,0,107
860Z200US11548,ZCTA5 11548,1299,191,20,171
860Z200US11549,ZCTA5 11549,0,0,0,0
860Z200US11550,ZCTA5 11550,59569,13762,3810,9952
860Z200US11552,ZCTA5 11552,26002,6523,1512,5011
860Z200US11553,ZCTA5 11553,26239,5609,1601,4008
860Z200US11554,ZCTA5 11554,35739,7457,2129,5328
860Z200US11556,ZCTA5 11556,0,0,0,0
860Z200US11557,ZCTA5 11557,8290,2180,448,1732
860Z200US11558,ZCTA5 11558,8480,1364,480,884
860Z200US11559,ZCTA5 11559,8732,2478,597,1881
860Z200US11560,ZCTA5 11560,6979,1593,339,1254
860Z200US11561,ZCTA5 11561,37622,5315,1651,3664
860Z200US11563,ZCTA5 11563,21901,4351,1257,3094
860Z200US11565,ZCTA5 11565,9013,1810,644,1166
860Z200US11566,ZCTA5 11566,33780,7468,2066,5402
860Z200US11568,ZCTA5 11568,3119,556,58,498
860Z200US11569,ZCTA5 11569,1110,124,0,124
860Z200US11570,ZCTA5 11570,28009,6367,1520,4847
860Z200US11572,ZCTA5 11572,29676,5992,1191,4801
860Z200US11575,ZCTA5 11575,18747,4432,1536,2896
860Z200US11576,ZCTA5 11576,12503,2439,463,1976
860Z200US11577,ZCTA5 11577,12134,2992,388,2604
860Z200US11579,ZCTA5 11579,5031,1304,316,988
860Z200US11580,ZCTA5 11580,43218,7339,1272,6067
860Z200US11581,ZCTA5 11581,22758,5788,1245,4543
860Z200US11590,ZCTA5 11590,47579,10183,2927,7256
860Z200US11596,ZCTA5 11596,10520,2598,568,2030
860Z200US11598,ZCTA5 11598,14308,4945,1098,3847
860Z200US11691,ZCTA5 11691,68122,20669,5821,14848
860Z200US11692,ZCTA5 11692,23710,6960,1708,5252
860Z200US11693,ZCTA5 11693,13357,2715,589,2126
860Z200US11694,ZCTA5 11694,21067,4806,1366,3440
860Z200US11697,ZCTA5 11697,3946,712,230,482
860Z200US11701,ZCTA5 11701,27229,5337,1246,4091
860Z200US11702,ZCTA5 11702,14015,2445,791,1654
860Z200US11703,ZCTA5 11703,17343,3587,783,2804
860Z200US11704,ZCTA5 11704,39224,7057,1704,5353
860Z200US11705,ZCTA5 11705,8409,1633,402,1231
860Z200US11706,ZCTA5 11706,64977,15250,3936,11314
860Z200US11709,ZCTA5 11709,6749,1117,184,933
860Z200US11710,ZCTA5 11710,34825,8045,1694,6351
860Z200US11713,ZCTA5 11713,8887,1645,445,1200
860Z200US11714,ZCTA5 11714,22444,4700,1199,3501
860Z200US11715,ZCTA5 11715,3786,727,122,605
860Z200US11716,ZCTA5 11716,10035,2158,635,1523
860Z200US11717,ZCTA5 11717,63624,13970,3624,10346
860Z200US11718,ZCTA5 11718,3176,897,136,761
860Z200US11719,ZCTA5 11719,3155,555,103,452
860Z200US11720,ZCTA5 11720,29036,6552,1587,4965
860Z200US11721,ZCTA5 11721,6569,1368,331,1037
860Z200US11722,ZCTA5 11722,36259,8297,2144,6153
860Z200US11724,ZCTA5 11724,2808,849,241,608
860Z200US11725,ZCTA5 11725,28283,6089,1450,4639
860Z200US11726,ZCTA5 11726,21097,4294,1059,3235
860Z200US11727,ZCTA5 11727,29845,5467,1772,3695
860Z200US11729,ZCTA5 11729,26449,5117,1107,4010
860Z200US11730,ZCTA5 11730,14025,2831,687,2144
860Z200US11731,ZCTA5 11731,30576,6469,1849,4620
860Z200US11732,ZCTA5 11732,3517,666,108,558
860Z200US11733,ZCTA5 11733,16876,3697,677,3020
860Z200US11735,ZCTA5 11735,32150,5625,1506,4119
860Z200US11738,ZCTA5 11738,19635,4453,1365,3088
860Z200US11739,ZCTA5 11739,1400,195,22,173
860Z200US11740,ZCTA5 11740,10776,2450,478,1972
860Z200US11741,ZCTA5 11741,27590,6035,1593,4442
860Z200US11742,ZCTA5 11742,13438,2870,828,2042
860Z200US11743,ZCTA5 11743,41200,8087,1476,6611
860Z200US11746,ZCTA5 11746,67026,13925,3318,10607
860Z200US11747,ZCTA5 11747,19401,3601,931,2670
860Z200US11749,ZCTA5 11749,3532,676,175,501
860Z200US11751,ZCTA5 11751,13476,2284,677,1607
860Z200US11752,ZCTA5 11752,9112,1744,365,1379
860Z200US11753,ZCTA5 11753,13041,3504,575,2929
860Z200US11754,ZCTA5 11754,18194,3752,1023,2729
860Z200US11755,ZCTA5 11755,12204,2751,462,2289
860Z200US11756,ZCTA5 11756,42341,7627,2299,5328
860Z200US11757,ZCTA5 11757,44765,8416,2263,6153
860Z200US11758,ZCTA5 11758,54023,10260,2906,7354
860Z200US11762,ZCTA5 11762,22293,4499,1328,3171
860Z200US11763,ZCTA5 11763,29194,6284,1315,4969
860Z200US11764,ZCTA5 11764,12670,2900,429,2471
860Z200US11765,ZCTA5 11765,708,187,39,148
860Z200US11766,ZCTA5 11766,11476,2699,478,2221
860Z200US11767,ZCTA5 11767,14289,3023,631,2392
860Z200US11768,ZCTA5 11768,21159,4138,792,3346
860Z200US11769,ZCTA5 11769,8869,1265,337,928
860Z200US11770,ZCTA5 11770,112,17,0,17
860Z200US11771,ZCTA5 11771,10064,2176,879,1297
860Z200US11772,ZCTA5 11772,45081,8631,2457,6174
860Z200US11776,ZCTA5 11776,23962,5459,1148,4311
860Z200US11777,ZCTA5 11777,9101,1742,367,1375
860Z200US11778,ZCTA5 11778,12496,2984,887,2097
860Z200US11779,ZCTA5 11779,38545,7753,2057,5696
860Z200US11780,ZCTA5 11780,15256,3114,546,2568
860Z200US11782,ZCTA5 11782,14905,3383,791,2592
860Z200US11783,ZCTA5 11783,21836,4450,859,3591
860Z200US11784,ZCTA5 11784,25367,5610,1626,3984
860Z200US11786,ZCTA5 11786,6553,1642,228,1414
860Z200US11787,ZCTA5 11787,33751,6905,1406,5499
860Z200US11788,ZCTA5 11788,16965,3266,1039,2227
860Z200US11789,ZCTA5 11789,7434,1752,194,1558
860Z200US11790,ZCTA5 11790,12209,2536,654,1882
860Z200US11791,ZCTA5 11791,25539,7105,1036,6069
860Z200US11792,ZCTA5 11792,8526,1546,411,1135
860Z200US11793,ZCTA5 11793,30741,6848,1496,5352
860Z200US11794,ZCTA5 11794,0,0,0,0
860Z200US11795,ZCTA5 11795,25327,5212,1370,3842
860Z200US11796,ZCTA5 11796,3836,750,214,536
860Z200US11797,ZCTA5 11797,8228,1826,570,1256
860Z200US11798,ZCTA5 11798,18075,4243,1049,3194
860Z200US11801,ZCTA5 11801,41897,7070,1563,5507
860Z200US11803,ZCTA5 11803,30109,6812,1364,5448
860Z200US11804,ZCTA5 11804,4443,1186,294,892
860Z200US11901,ZCTA5 11901,30798,6129,2252,3877
860Z200US11930,ZCTA5 11930,741,66,18,48
860Z200US11931,ZCTA5 11931,0,0,0,0
860Z200US11932,ZCTA5 11932,1032,210,0,210
860Z200US11933,ZCTA5 11933,6966,1294,273,1021
860Z200US11934,ZCTA5 11934,7668,1882,532,1350
860Z200US11935,ZCTA5 11935,2803,319,43,276
860Z200US11937,ZCTA5 11937,20985,3992,1312,2680
860Z200US11939,ZCTA5 11939,1564,152,37,115
860Z200US11940,ZCTA5 11940,5445,1199,268,931
860Z200US11941,ZCTA5 11941,2493,458,119,339
860Z200US11942,ZCTA5 11942,5529,933,193,740
860Z200US11944,ZCTA5 11944,4598,608,84,524
860Z200US11946,ZCTA5 11946,17497,3378,933,2445
860Z200US11947,ZCTA5 11947,153,0,0,0
860Z200US11948,ZCTA5 11948,535,74,14,60
860Z200US11949,ZCTA5 11949,13187,2528,569,1959
860Z200US11950,ZCTA5 11950,16338,4200,1090,3110
860Z200US11951,ZCTA5 11951,14923,4103,1203,2900
860Z200US11952,ZCTA5 11952,5231,840,147,693
860Z200US11953,ZCTA5 11953,13394,2490,691,1799
860Z200US11954,ZCTA5 11954,4273,712,226,486
860Z200US11955,ZCTA5 11955,2857,405,267,138
860Z200US11956,ZCTA5 11956,305,31,13,18
860Z200US11957,ZCTA5 11957,1220,0,0,0
860Z200US11958,ZCTA5 11958,893,213,38,175
860Z200US11959,ZCTA5 11959,632,148,42,106
860Z200US11960,ZCTA5 11960,962,155,20,135
860Z200US11961,ZCTA5 11961,13041,2224,404,1820
860Z200US11962,ZCTA5 11962,344,53,0,53
860Z200US11963,ZCTA5 11963,8444,1681,326,1355
860Z200US11964,ZCTA5 11964,3100,770,379,391
860Z200US11965,ZCTA5 11965,491,0,0,0
860Z200US11967,ZCTA5 11967,26496,5647,1208,4439
860Z200US11968,ZCTA5 11968,13284,2237,536,1701
860Z200US11970,ZCTA5 11970,563,0,0,0
860Z200US11971,ZCTA5 11971,6244,1442,323,1119
860Z200US11972,ZCTA5 11972,413,134,0,134
860Z200US11973,ZCTA5 11973,0,0,0,0
860Z200US11975,ZCTA5 11975,426,41,13,28
860Z200US11976,ZCTA5 11976,2437,279,102,177
860Z200US11977,ZCTA5 11977,2958,709,180,529
860Z200US11978,ZCTA5 11978,3969,705,101,604
860Z200US11980,ZCTA5 11980,5120,781,339,442
860Z200US12007,ZCTA5 12007,325,86,0,86
860Z200US12008,ZCTA5 12008,427,132,43,89
860Z200US12009,ZCTA5 12009,8302,1671,413,1258
860Z200US12010,ZCTA5 12010,26804,6101,1515,4586
860Z200US12015,ZCTA5 12015,4135,638,126,512
860Z200US12017,ZCTA5 12017,419,36,0,36
860Z200US12018,ZCTA5 12018,7300,1452,477,975
860Z200US12019,ZCTA5 12019,15249,3118,587,2531
860Z200US12020,ZCTA5 12020,34010,6427,1075,5352
860Z200US12022,ZCTA5 12022,1038,247,48,199
860Z200US12023,ZCTA5 12023,2369,562,139,423
860Z200US12024,ZCTA5 12024,83,7,0,7
860Z200US12025,ZCTA5 12025,5239,717,273,444
860Z200US12027,ZCTA5 12027,4229,944,247,697
860Z200US12028,ZCTA5 12028,1082,260,56,204
860Z200US12029,ZCTA5 12029,914,86,10,76
860Z200US12031,ZCTA5 12031,191,31,25,6
860Z200US12032,ZCTA5 12032,735,80,22,58
860Z200US12033,ZCTA5 12033,7569,1265,316,949
860Z200US12035,ZCTA5 12035,484,90,0,90
860Z200US12036,ZCTA5 12036,220,52,32,20
860Z200US12037,ZCTA5 12037,4083,748,228,520
860Z200US12040,ZCTA5 12040,28,0,0,0
860Z200US12041,ZCTA5 12041,319,9,0,9
860Z200US12042,ZCTA5 12042,297,31,0,31
860Z200US12043,ZCTA5 12043,6492,1046,213,833
860Z200US12045,ZCTA5 12045,467,166,33,133
860Z200US12046,ZCTA5 12046,519,97,28,69
860Z200US12047,ZCTA5 12047,22503,5216,1174,4042
860Z200US12051,ZCTA5 12051,4008,888,250,638
860Z200US12052,ZCTA5 12052,1974,431,128,303
860Z200US12053,ZCTA5 12053,4253,819,125,694
860Z200US12054,ZCTA5 12054,16871,3432,716,2716
860Z200US12056,ZCTA5 12056,2029,352,62,290
860Z200US12057,ZCTA5 12057,1997,315,133,182
860Z200US12058,ZCTA5 12058,1160,151,0,151
860Z200US12059,ZCTA5 12059,1417,200,20,180
860Z200US12060,ZCTA5 12060,1811,208,19,189
860Z200US12061,ZCTA5 12061,9888,2208,737,1471
860Z200US12062,ZCTA5 12062,1662,193,56,137
860Z200US12063,ZCTA5 12063,609,62,26,36
860Z200US12064,ZCTA5 12064,251,19,12,7
860Z200US12065,ZCTA5 12065,44371,9861,2393,7468
860Z200US12066,ZCTA5 12066,1834,375,151,224
860Z200US12067,ZCTA5 12067,1457,368,52,316
860Z200US12068,ZCTA5 12068,2481,565,63,502
860Z200US12069,ZCTA5 12069,483,50,25,25
860Z200US12070,ZCTA5 12070,2465,302,36,266
860Z200US12071,ZCTA5 12071,217,45,14,31
860Z200US12072,ZCTA5 12072,2908,770,224,546
860Z200US12074,ZCTA5 12074,2949,598,197,401
860Z200US12075,ZCTA5 12075,3000,460,72,388
860Z200US12076,ZCTA5 12076,1265,206,33,173
860Z200US12077,ZCTA5 12077,6745,1476,549,927
860Z200US12078,ZCTA5 12078,22740,4724,1069,3655
860Z200US12082,ZCTA5 12082,2,0,0,0
860Z200US12083,ZCTA5 12083,3728,856,167,689
860Z200US12084,ZCTA5 12084,4869,1060,287,773
860Z200US12085,ZCTA5 12085,149,22,0,22
860Z200US12086,ZCTA5 12086,1648,194,59,135
860Z200US12087,ZCTA5 12087,1279,194,51,143
860Z200US12090,ZCTA5 12090,5695,1390,439,951
860Z200US12092,ZCTA5 12092,1604,318,44,274
860Z200US12093,ZCTA5 12093,1385,194,53,141
860Z200US12094,ZCTA5 12094,2676,582,80,502
860Z200US12095,ZCTA5 12095,12078,2533,626,1907
860Z200US12106,ZCTA5 12106,2171,398,58,340
860Z200US12108,ZCTA5 12108,383,27,3,24
860Z200US12110,ZCTA5 12110,19227,3587,809,2778
860Z200US12115,ZCTA5 12115,95,0,0,0
860Z200US12116,ZCTA5 12116,1351,260,54,206
860Z200US12117,ZCTA5 12117,2702,382,128,254
860Z200US12118,ZCTA5 12118,16537,3243,994,2249
860Z200US12120,ZCTA5 12120,629,102,36,66
860Z200US12121,ZCTA5 12121,2267,396,30,366
860Z200US12122,ZCTA5 12122,3581,457,133,324
860Z200US12123,ZCTA5 12123,4889,989,323,666
860Z200US12124,ZCTA5 12124,236,32,32,0
860Z200US12125,ZCTA5 12125,1066,130,48,82
860Z200US12130,ZCTA5 12130,431,189,8,181
860Z200US12131,ZCTA5 12131,188,46,17,29
860Z200US12132,ZCTA5 12132,133,36,13,23
860Z200US12134,ZCTA5 12134,4297,733,178,555
860Z200US12136,ZCTA5 12136,790,76,9,67
860Z200US12137,ZCTA5 12137,2035,440,82,358
860Z200US12138,ZCTA5 12138,2917,573,113,460
860Z200US12139,ZCTA5 12139,286,33,13,20
860Z200US12140,ZCTA5 12140,1412,215,97,118
860Z200US12143,ZCTA5 12143,5406,808,205,603
860Z200US12144,ZCTA5 12144,21639,3833,1206,2627
860Z200US12147,ZCTA5 12147,412,50,0,50
860Z200US12148,ZCTA5 12148,4371,788,161,627
860Z200US12149,ZCTA5 12149,2198,473,103,370
860Z200US12150,ZCTA5 12150,589,77,67,10
860Z200US12151,ZCTA5 12151,871,161,53,108
860Z200US12153,ZCTA5 12153,703,154,5,149
860Z200US12154,ZCTA5 12154,2820,431,98,333
860Z200US12155,ZCTA5 12155,1748,321,19,302
860Z200US12156,ZCTA5 12156,796,228,41,187
860Z200US12157,ZCTA5 12157,4515,993,262,731
860Z200US12158,ZCTA5 12158,6045,1098,228,870
860Z200US12159,ZCTA5 12159,8556,1539,316,1223
860Z200US12160,ZCTA5 12160,829,124,60,64
860Z200US12161,ZCTA5 12161,35,9,9,0
860Z200US12164,ZCTA5 12164,485,38,7,31
860Z200US12165,ZCTA5 12165,198,26,14,12
860Z200US12166,ZCTA5 12166,1501,291,119,172
860Z200US12167,ZCTA5 12167,2311,350,93,257
860Z200US12168,ZCTA5 12168,1694,239,75,164
860Z200US12169,ZCTA5 12169,378,127,9,118
860Z200US12170,ZCTA5 12170,5225,1042,334,708
860Z200US12172,ZCTA5 12172,211,71,40,31
860Z200US12173,ZCTA5 12173,2038,652,90,562
860Z200US12174,ZCTA5 12174,588,80,14,66
860Z200US12175,ZCTA5 12175,700,166,27,139
860Z200US12176,ZCTA5 12176,357,65,15,50
860Z200US12177,ZCTA5 12177,455,105,43,62
860Z200US12180,ZCTA5 12180,48964,8481,2227,6254
860Z200US12182,ZCTA5 12182,14674,3316,635,2681
860Z200US12183,ZCTA5 12183,2959,530,246,284
860Z200US12184,ZCTA5 12184,7082,1384,347,1037
860Z200US12185,ZCTA5 12185,1784,287,85,202
860Z200US12186,ZCTA5 12186,6325,1073,240,833
860Z200US12187,ZCTA5 12187,685,76,16,60
860Z200US12188,ZCTA5 12188,11609,2062,465,1597
860Z200US12189,ZCTA5 12189,18444,3791,964,2827
860Z200US12190,ZCTA5 12190,641,153,41,112
860Z200US12192,ZCTA5 12192,1496,190,0,190
860Z200US12193,ZCTA5 12193,1674,251,74,177
860Z200US12194,ZCTA5 12194,177,44,2,42
860Z200US12195,ZCTA5 12195,184,0,0,0
860Z200US12196,ZCTA5 12196,3954,1237,162,1075
860Z200US12197,ZCTA5 12197,1929,226,74,152
860Z200US12198,ZCTA5 12198,7142,1468,236,1232
860Z200US12202,ZCTA5 12202,9692,1921,797,1124
860Z200US12203,ZCTA5 12203,28022,3501,1014,2487
860Z200US12204,ZCTA5 12204,8715,1987,830,1157
860Z200US12205,ZCTA5 12205,26407,5411,1306,4105
860Z200US12206,ZCTA5 12206,14747,3394,446,2948
860Z200US12207,ZCTA5 12207,2311,306,190,116
860Z200US12208,ZCTA5 12208,21653,2709,909,1800
860Z200US12209,ZCTA5 12209,10340,2192,837,1355
860Z200US12210,ZCTA5 12210,9708,1176,282,894
860Z200US12211,ZCTA5 12211,10650,2306,795,1511
860Z200US12222,ZCTA5 12222,23,0,0,0
860Z200US12226,ZCTA5 12226,0,0,0,0
860Z200US12302,ZCTA5 12302,27414,6131,1485,4646
860Z200US12303,ZCTA5 12303,29430,6231,1262,4969
860Z200US12304,ZCTA5 12304,21711,4739,1310,3429
860Z200US12305,ZCTA5 12305,5794,487,237,250
860Z200US12306,ZCTA5 12306,27729,5801,1803,3998
860Z200US12307,ZCTA5 12307,7863,1894,553,1341
860Z200US12308,ZCTA5 12308,12733,2278,796,1482
860Z200US12309,ZCTA5 12309,32992,7982,2374,5608
860Z200US12401,ZCTA5 12401,34602,6985,2081,4904
860Z200US12404,ZCTA5 12404,3864,961,198,763
860Z200US12405,ZCTA5 12405,550,40,17,23
860Z200US12406,ZCTA5 12406,590,59,1,58
860Z200US12407,ZCTA5 12407,132,18,4,14
860Z200US12409,ZCTA5 12409,958,146,56,90
860Z200US12410,ZCTA5 12410,329,20,0,20
860Z200US12411,ZCTA5 12411,361,33,25,8
860Z200US12412,ZCTA5 12412,537,45,0,45
860Z200US12413,ZCTA5 12413,3130,580,75,505
860Z200US12414,ZCTA5 12414,9787,1390,558,832
860Z200US12416,ZCTA5 12416,205,0,0,0
860Z200US12417,ZCTA5 12417,873,95,0,95
860Z200US12418,ZCTA5 12418,294,47,29,18
860Z200US12419,ZCTA5 12419,881,174,83,91
860Z200US12420,ZCTA5 12420,351,99,99,0
860Z200US12421,ZCTA5 12421,224,13,0,13
860Z200US12422,ZCTA5 12422,398,41,0,41
860Z200US12423,ZCTA5 12423,1255,377,9,368
860Z200US12424,ZCTA5 12424,239,0,0,0
860Z200US12427,ZCTA5 12427,932,219,126,93
860Z200US12428,ZCTA5 12428,7025,1335,153,1182
860Z200US12429,ZCTA5 12429,153,0,0,0
860Z200US12430,ZCTA5 12430,1284,245,39,206
860Z200US12431,ZCTA5 12431,1787,284,107,177
860Z200US12432,ZCTA5 12432,581,110,0,110
860Z200US12433,ZCTA5 12433,628,189,59,130
860Z200US12434,ZCTA5 12434,984,212,85,127
860Z200US12435,ZCTA5 12435,231,43,7,36
860Z200US12436,ZCTA5 12436,430,9,0,9
860Z200US12438,ZCTA5 12438,48,9,0,9
860Z200US12439,ZCTA5 12439,297,34,8,26
860Z200US12440,ZCTA5 12440,1479,154,38,116
860Z200US12441,ZCTA5 12441,105,0,0,0
860Z200US12442,ZCTA5 12442,648,44,30,14
860Z200US12443,ZCTA5 12443,3540,538,181,357
860Z200US12444,ZCTA5 12444,538,14,0,14
860Z200US12446,ZCTA5 12446,4866,941,270,671
860Z200US12448,ZCTA5 12448,142,0,0,0
860Z200US12449,ZCTA5 12449,2765,502,100,402
860Z200US12450,ZCTA5 12450,221,36,10,26
860Z200US12451,ZCTA5 12451,1044,106,64,42
860Z200US12452,ZCTA5 12452,27,0,0,0
860Z200US12453,ZCTA5 12453,240,0,0,0
860Z200US12454,ZCTA5 12454,456,149,36,113
860Z200US12455,ZCTA5 12455,1738,319,46,273
860Z200US12456,ZCTA5 12456,708,181,17,164
860Z200US12457,ZCTA5 12457,1283,236,99,137
860Z200US12458,ZCTA5 12458,2209,234,61,173
860Z200US12459,ZCTA5 12459,68,0,0,0
860Z200US12460,ZCTA5 12460,215,56,43,13
860Z200US12461,ZCTA5 12461,1367,198,71,127
860Z200US12463,ZCTA5 12463,1341,204,22,182
860Z200US12464,ZCTA5 12464,1048,22,14,8
860Z200US12465,ZCTA5 12465,384,18,10,8
860Z200US12466,ZCTA5 12466,2055,508,101,407
860Z200US12468,ZCTA5 12468,1306,140,51,89
860Z200US12469,ZCTA5 12469,803,81,24,57
860Z200US12470,ZCTA5 12470,778,142,62,80
860Z200US12471,ZCTA5 12471,268,0,0,0
860Z200US12472,ZCTA5 12472,1177,157,24,133
860Z200US12473,ZCTA5 12473,663,97,0,97
860Z200US12474,ZCTA5 12474,856,107,19,88
860Z200US12475,ZCTA5 12475,460,75,24,51
860Z200US12477,ZCTA5 12477,18531,3272,695,2577
860Z200US12480,ZCTA5 12480,324,47,5,42
860Z200US12481,ZCTA5 12481,1493,84,0,84
860Z200US12482,ZCTA5 12482,550,10,0,10
860Z200US12483,ZCTA5 12483,71,14,0,14
860Z200US12484,ZCTA5 12484,3326,546,127,419
860Z200US12485,ZCTA5 12485,904,294,46,248
860Z200US12486,ZCTA5 12486,1760,285,45,240
860Z200US12487,ZCTA5 12487,3785,567,45,522
860Z200US12489,ZCTA5 12489,154,0,0,0
860Z200US12490,ZCTA5 12490,0,0,0,0
860Z200US12491,ZCTA5 12491,2044,479,128,351
860Z200US12492,ZCTA5 12492,181,14,7,7
860Z200US12493,ZCTA5 12493,307,0,0,0
860Z200US12494,ZCTA5 12494,865,182,32,150
860Z200US12495,ZCTA5 12495,87,0,0,0
860Z200US12496,ZCTA5 12496,1307,165,34,131
860Z200US12498,ZCTA5 12498,4570,480,66,414
860Z200US12501,ZCTA5 12501,2108,356,40,316
860Z200US12502,ZCTA5 12502,1086,179,47,132
860Z200US12503,ZCTA5 12503,776,127,16,111
860Z200US12504,ZCTA5 12504,0,0,0,0
860Z200US12507,ZCTA5 12507,187,52,0,52
860Z200US12508,ZCTA5 12508,17503,3356,689,2667
860Z200US12512,ZCTA5 12512,184,12,12,0
860Z200US12513,ZCTA5 12513,154,0,0,0
860Z200US12514,ZCTA5 12514,2959,381,94,287
860Z200US12515,ZCTA5 12515,1567,213,55,158
860Z200US12516,ZCTA5 12516,1853,163,36,127
860Z200US12517,ZCTA5 12517,364,38,0,38
860Z200US12518,ZCTA5 12518,5856,1214,361,853
860Z200US12520,ZCTA5 12520,3034,560,60,500
860Z200US12521,ZCTA5 12521,1607,198,11,187
860Z200US12522,ZCTA5 12522,4775,690,142,548
860Z200US12523,ZCTA5 12523,1978,409,81,328
860Z200US12524,ZCTA5 12524,14498,2583,555,2028
860Z200US12525,ZCTA5 12525,1737,430,29,401
860Z200US12526,ZCTA5 12526,3519,336,83,253
860Z200US12527,ZCTA5 12527,16,0,0,0
860Z200US12528,ZCTA5 12528,12968,2329,702,1627
860Z200US12529,ZCTA5 12529,2258,274,102,172
860Z200US12530,ZCTA5 12530,283,0,0,0
860Z200US12531,ZCTA5 12531,2484,508,180,328
860Z200US12533,ZCTA5 12533,26243,6625,1765,4860
860Z200US12534,ZCTA5 12534,17040,2670,655,2015
860Z200US12538,ZCTA5 12538,12474,2050,499,1551
860Z200US12540,ZCTA5 12540,9289,2294,568,1726
860Z200US12542,ZCTA5 12542,5447,1022,233,789
860Z200US12543,ZCTA5 12543,3135,587,199,388
860Z200US12544,ZCTA5 12544,33,0,0,0
860Z200US12545,ZCTA5 12545,4385,591,117,474
860Z200US12546,ZCTA5 12546,2679,484,121,363
860Z200US12547,ZCTA5 12547,3251,715,155,560
860Z200US12548,ZCTA5 12548,992,79,9,70
860Z200US12549,ZCTA5 12549,10551,2557,420,2137
860Z200US12550,ZCTA5 12550,54446,11448,2811,8637
860Z200US12553,ZCTA5 12553,27157,5890,1145,4745
860Z200US12561,ZCTA5 12561,15226,2176,527,1649
860Z200US12563,ZCTA5 12563,7041,1041,177,864
860Z200US12564,ZCTA5 12564,7488,1603,281,1322
860Z200US12565,ZCTA5 12565,1444,285,148,137
860Z200US12566,ZCTA5 12566,12351,2417,616,1801
860Z200US12567,ZCTA5 12567,2347,336,101,235
860Z200US12569,ZCTA5 12569,9556,1840,533,1307
860Z200US12570,ZCTA5 12570,6919,1668,509,1159
860Z200US12571,ZCTA5 12571,9118,1793,272,1521
860Z200US12572,ZCTA5 12572,8838,1239,142,1097
860Z200US12574,ZCTA5 12574,293,16,16,0
860Z200US12575,ZCTA5 12575,1584,291,81,210
860Z200US12577,ZCTA5 12577,1552,239,54,185
860Z200US12578,ZCTA5 12578,2123,301,28,273
860Z200US12580,ZCTA5 12580,4261,690,199,491
860Z200US12581,ZCTA5 12581,2036,406,157,249
860Z200US12582,ZCTA5 12582,4422,853,161,692
860Z200US12583,ZCTA5 12583,1822,331,39,292
860Z200US12585,ZCTA5 12585,842,58,22,36
860Z200US12586,ZCTA5 12586,12493,2965,718,2247
860Z200US12589,ZCTA5 12589,18581,3555,973,2582
860Z200US12590,ZCTA5 12590,36578,6145,1286,4859
860Z200US12592,ZCTA5 12592,1426,439,74,365
860Z200US12594,ZCTA5 12594,4112,590,58,532
860Z200US12601,ZCTA5 12601,40535,8139,2394,5745
860Z200US12603,ZCTA5 12603,41450,7981,2176,5805
860Z200US12604,ZCTA5 12604,150,0,0,0
860Z200US12701,ZCTA5 12701,12113,2373,695,1678
860Z200US12719,ZCTA5 12719,1132,84,47,37
860Z200US12720,ZCTA5 12720,274,72,0,72
860Z200US12721,ZCTA5 12721,7835,2184,742,1442
860Z200US12722,ZCTA5 12722,0,0,0,0
860Z200US12723,ZCTA5 12723,1775,199,15,184
860Z200US12724,ZCTA5 12724,78,0,0,0
860Z200US12725,ZCTA5 12725,323,89,25,64
860Z200US12726,ZCTA5 12726,1357,290,129,161
860Z200US12729,ZCTA5 12729,1327,250,145,105
860Z200US12732,ZCTA5 12732,830,80,19,61
860Z200US12733,ZCTA5 12733,659,309,31,278
860Z200US12734,ZCTA5 12734,872,127,0,127
860Z200US12736,ZCTA5 12736,122,0,0,0
860Z200US12737,ZCTA5 12737,1595,369,91,278
860Z200US12738,ZCTA5 12738,359,92,0,92
860Z200US12740,ZCTA5 12740,1695,320,66,254
860Z200US12741,ZCTA5 12741,168,15,0,15
860Z200US12742,ZCTA5 12742,194,31,0,31
860Z200US12743,ZCTA5 12743,310,31,0,31
860Z200US12745,ZCTA5 12745,5,0,0,0
860Z200US12746,ZCTA5 12746,600,97,44,53
860Z200US12747,ZCTA5 12747,2000,491,57,434
860Z200US12748,ZCTA5 12748,1749,240,10,230
860Z200US12749,ZCTA5 12749,538,137,0,137
860Z200US12750,ZCTA5 12750,36,4,4,0
860Z200US12751,ZCTA5 12751,1151,489,247,242
860Z200US12752,ZCTA5 12752,302,13,6,7
860Z200US12754,ZCTA5 12754,7578,2228,687,1541
860Z200US12758,ZCTA5 12758,3841,679,250,429
860Z200US12759,ZCTA5 12759,1929,717,80,637
860Z200US12760,ZCTA5 12760,425,26,3,23
860Z200US12762,ZCTA5 12762,350,51,0,51
860Z200US12763,ZCTA5 12763,454,23,6,17
860Z200US12764,ZCTA5 12764,1713,231,42,189
860Z200US12765,ZCTA5 12765,891,142,19,123
860Z200US12766,ZCTA5 12766,658,122,0,122
860Z200US12767,ZCTA5 12767,225,37,37,0
860Z200US12768,ZCTA5 12768,866,103,27,76
860Z200US12769,ZCTA5 12769,363,26,26,0
860Z200US12770,ZCTA5 12770,180,25,0,25
860Z200US12771,ZCTA5 12771,14282,3001,688,2313
860Z200US12775,ZCTA5 12775,2465,450,143,307
860Z200US12776,ZCTA5 12776,2000,371,48,323
860Z200US12777,ZCTA5 12777,835,94,36,58
860Z200US12778,ZCTA5 12778,402,99,0,99
860Z200US12779,ZCTA5 12779,2304,710,219,491
860Z200US12780,ZCTA5 12780,2258,411,21,390
860Z200US12781,ZCTA5 12781,202,10,0,10
860Z200US12783,ZCTA5 12783,1395,270,79,191
860Z200US12784,ZCTA5 12784,0,0,0,0
860Z200US12785,ZCTA5 12785,1041,346,0,346
860Z200US12786,ZCTA5 12786,568,72,0,72
860Z200US12787,ZCTA5 12787,97,0,0,0
860Z200US12788,ZCTA5 12788,2091,373,66,307
860Z200US12789,ZCTA5 12789,2331,492,142,350
860Z200US12790,ZCTA5 12790,4210,803,217,586
860Z200US12791,ZCTA5 12791,690,269,13,256
860Z200US12792,ZCTA5 12792,167,14,0,14
860Z200US12801,ZCTA5 12801,14550,2939,793,2146
860Z200US12803,ZCTA5 12803,8808,1715,526,1189
860Z200US12804,ZCTA5 12804,27557,4926,1230,3696
860Z200US12808,ZCTA5 12808,201,4,4,0
860Z200US12809,ZCTA5 12809,3456,727,211,516
860Z200US12810,ZCTA5 12810,537,95,36,59
860Z200US12811,ZCTA5 12811,225,64,17,47
860Z200US12812,ZCTA5 12812,349,0,0,0
860Z200US12814,ZCTA5 12814,1135,87,17,70
860Z200US12815,ZCTA5 12815,1076,128,15,113
860Z200US12816,ZCTA5 12816,4620,962,118,844
860Z200US12817,ZCTA5 12817,1950,206,40,166
860Z200US12819,ZCTA5 12819,286,45,7,38
860Z200US12820,ZCTA5 12820,102,44,0,44
860Z200US12821,ZCTA5 12821,331,46,6,40
860Z200US12822,ZCTA5 12822,6189,1305,423,882
860Z200US12823,ZCTA5 12823,502,139,0,139
860Z200US12824,ZCTA5 12824,1088,171,62,109
860Z200US12827,ZCTA5 12827,3666,769,329,440
860Z200US12828,ZCTA5 12828,9411,1521,340,1181
860Z200US12831,ZCTA5 12831,18270,4176,1215,2961
860Z200US12832,ZCTA5 12832,6381,1142,255,887
860Z200US12833,ZCTA5 12833,5233,962,311,651
860Z200US12834,ZCTA5 12834,6174,1030,252,778
860Z200US12835,ZCTA5 12835,2545,269,64,205
860Z200US12836,ZCTA5 12836,461,13,2,11
860Z200US12837,ZCTA5 12837,873,171,13,158
860Z200US12838,ZCTA5 12838,721,133,37,96
860Z200US12839,ZCTA5 12839,13440,2205,461,1744
860Z200US12841,ZCTA5 12841,95,0,0,0
860Z200US12842,ZCTA5 12842,705,100,26,74
860Z200US12843,ZCTA5 12843,678,153,23,130
860Z200US12844,ZCTA5 12844,280,32,0,32
860Z200US12845,ZCTA5 12845,4426,679,210,469
860Z200US12846,ZCTA5 12846,3004,362,71,291
860Z200US12847,ZCTA5 12847,687,86,27,59
860Z200US12849,ZCTA5 12849,425,95,31,64
860Z200US12850,ZCTA5 12850,2729,521,103,418
860Z200US12851,ZCTA5 12851,318,64,21,43
860Z200US12852,ZCTA5 12852,349,33,4,29
860Z200US12853,ZCTA5 12853,1294,303,49,254
860Z200US12854,ZCTA5 12854,98,49,31,18
860Z200US12855,ZCTA5 12855,207,23,8,15
860Z200US12856,ZCTA5 12856,313,34,0,34
860Z200US12857,ZCTA5 12857,726,83,16,67
860Z200US12858,ZCTA5 12858,146,6,0,6
860Z200US12859,ZCTA5 12859,1855,543,122,421
860Z200US12860,ZCTA5 12860,359,64,35,29
860Z200US12861,ZCTA5 12861,551,126,26,100
860Z200US12862,ZCTA5 12862,266,60,0,60
860Z200US12863,ZCTA5 12863,802,194,12,182
860Z200US12864,ZCTA5 12864,9,0,0,0
860Z200US12865,ZCTA5 12865,3442,609,202,407
860Z200US12866,ZCTA5 12866,36290,5432,1247,4185
860Z200US12870,ZCTA5 12870,1677,256,45,211
860Z200US12871,ZCTA5 12871,4166,792,184,608
860Z200US12872,ZCTA5 12872,103,0,0,0
860Z200US12873,ZCTA5 12873,869,125,71,54
860Z200US12874,ZCTA5 12874,155,10,0,10
860Z200US12878,ZCTA5 12878,767,197,25,172
860Z200US12883,ZCTA5 12883,4683,737,280,457
860Z200US12884,ZCTA5 12884,584,140,48,92
860Z200US12885,ZCTA5 12885,4393,879,134,745
860Z200US12886,ZCTA5 12886,217,0,0,0
860Z200US12887,ZCTA5 12887,4720,1164,370,794
860Z200US12901,ZCTA5 12901,29255,4796,1245,3551
860Z200US12903,ZCTA5 12903,1573,327,59,268
860Z200US12910,ZCTA5 12910,1530,299,71,228
860Z200US12911,ZCTA5 12911,0,0,0,0
860Z200US12912,ZCTA5 12912,1809,321,36,285
860Z200US12913,ZCTA5 12913,1056,238,25,213
860Z200US12914,ZCTA5 12914,876,169,41,128
860Z200US12915,ZCTA5 12915,58,0,0,0
860Z200US12916,ZCTA5 12916,2371,559,111,448
860Z200US12917,ZCTA5 12917,1224,329,59,270
860Z200US12918,ZCTA5 12918,2607,564,88,476
860Z200US12919,ZCTA5 12919,2716,474,174,300
860Z200US12920,ZCTA5 12920,2374,556,96,460
860Z200US12921,ZCTA5 12921,2732,665,200,465
860Z200US12922,ZCTA5 12922,37,4,2,2
860Z200US12923,ZCTA5 12923,506,95,35,60
860Z200US12924,ZCTA5 12924,308,55,0,55
860Z200US12926,ZCTA5 12926,2301,527,196,331
860Z200US12927,ZCTA5 12927,295,11,0,11
860Z200US12928,ZCTA5 12928,1869,320,95,225
860Z200US12929,ZCTA5 12929,965,227,64,163
860Z200US12930,ZCTA5 12930,839,238,117,121
860Z200US12932,ZCTA5 12932,996,126,25,101
860Z200US12933,ZCTA5 12933,27,0,0,0
860Z200US12934,ZCTA5 12934,1197,262,82,180
860Z200US12935,ZCTA5 12935,1395,258,51,207
860Z200US12936,ZCTA5 12936,671,103,12,91
860Z200US12937,ZCTA5 12937,1464,388,76,312
860Z200US12939,ZCTA5 12939,141,20,6,14
860Z200US12941,ZCTA5 12941,1664,241,48,193
860Z200US12942,ZCTA5 12942,509,24,13,11
860Z200US12943,ZCTA5 12943,292,13,1,12
860Z200US12944,ZCTA5 12944,3870,833,133,700
860Z200US12945,ZCTA5 12945,528,107,20,87
860Z200US12946,ZCTA5 12946,4596,898,140,758
860Z200US12950,ZCTA5 12950,623,109,27,82
860Z200US12952,ZCTA5 12952,265,94,29,65
860Z200US12953,ZCTA5 12953,10212,1886,686,1200
860Z200US12955,ZCTA5 12955,345,24,4,20
860Z200US12956,ZCTA5 12956,1112,148,58,90
860Z200US12957,ZCTA5 12957,1640,369,50,319
860Z200US12958,ZCTA5 12958,1829,352,42,310
860Z200US12959,ZCTA5 12959,1618,325,71,254
860Z200US12960,ZCTA5 12960,900,117,96,21
860Z200US12961,ZCTA5 12961,97,0,0,0
860Z200US12962,ZCTA5 12962,5047,1232,261,971
860Z200US12964,ZCTA5 12964,96,9,0,9
860Z200US12965,ZCTA5 12965,272,56,10,46
860Z200US12966,ZCTA5 12966,3072,905,269,636
860Z200US12967,ZCTA5 12967,1224,235,50,185
860Z200US12969,ZCTA5 12969,219,19,0,19
860Z200US12970,ZCTA5 12970,321,36,5,31
860Z200US12972,ZCTA5 12972,7038,1536,426,1110
860Z200US12973,ZCTA5 12973,169,41,5,36
860Z200US12974,ZCTA5 12974,2054,267,133,134
860Z200US12975,ZCTA5 12975,210,38,11,27
860Z200US12976,ZCTA5 12976,175,12,6,6
860Z200US12977,ZCTA5 12977,11,0,0,0
860Z200US12978,ZCTA5 12978,256,22,8,14
860Z200US12979,ZCTA5 12979,2534,569,139,430
860Z200US12980,ZCTA5 12980,1115,155,8,147
860Z200US12981,ZCTA5 12981,2397,614,83,531
860Z200US12983,ZCTA5 12983,7141,1217,339,878
860Z200US12985,ZCTA5 12985,915,102,5,97
860Z200US12986,ZCTA5 12986,5108,900,144,756
860Z200US12987,ZCTA5 12987,152,11,7,4
860Z200US12989,ZCTA5 12989,960,162,28,134
860Z200US12992,ZCTA5 12992,3774,627,222,405
860Z200US12993,ZCTA5 12993,1631,275,39,236
860Z200US12996,ZCTA5 12996,1972,288,58,230
860Z200US12997,ZCTA5 12997,1217,141,24,117
860Z200US12998,ZCTA5 12998,294,111,0,111
860Z200US13020,ZCTA5 13020,107,28,9,19
860Z200US13021,ZCTA5 13021,36605,6920,2061,4859
860Z200US13024,ZCTA5 13024,0,0,0,0
860Z200US13026,ZCTA5 13026,1310,209,27,182
860Z200US13027,ZCTA5 13027,35221,8215,1896,6319
860Z200US13028,ZCTA5 13028,804,190,38,152
860Z200US13029,ZCTA5 13029,7812,1986,581,1405
860Z200US13030,ZCTA5 13030,3946,1025,168,857
860Z200US13031,ZCTA5 13031,15650,3095,869,2226
860Z200US13032,ZCTA5 13032,12891,2422,552,1870
860Z200US13033,ZCTA5 13033,3641,868,197,671
860Z200US13034,ZCTA5 13034,2020,451,149,302
860Z200US13035,ZCTA5 13035,7270,1386,253,1133
860Z200US13036,ZCTA5 13036,8823,1554,486,1068
860Z200US13037,ZCTA5 13037,9596,2270,494,1776
860Z200US13039,ZCTA5 13039,16938,3730,968,2762
860Z200US13040,ZCTA5 13040,2602,538,122,416
860Z200US13041,ZCTA5 13041,11709,2658,517,2141
860Z200US13042,ZCTA5 13042,2012,431,62,369
860Z200US13044,ZCTA5 13044,3026,607,228,379
860Z200US13045,ZCTA5 13045,24670,4381,1250,3131
860Z200US13051,ZCTA5 13051,37,0,0,0
860Z200US13052,ZCTA5 13052,1763,335,108,227
860Z200US13053,ZCTA5 13053,4145,851,321,530
860Z200US13054,ZCTA5 13054,1218,344,31,313
860Z200US13057,ZCTA5 13057,14097,2303,554,1749
860Z200US13060,ZCTA5 13060,2731,580,208,372
860Z200US13061,ZCTA5 13061,622,74,16,58
860Z200US13062,ZCTA5 13062,212,32,26,6
860Z200US13063,ZCTA5 13063,1696,213,30,183
860Z200US13065,ZCTA5 13065,222,75,0,75
860Z200US13066,ZCTA5 13066,12750,2692,850,1842
860Z200US13068,ZCTA5 13068,4603,736,156,580
860Z200US13069,ZCTA5 13069,23163,4877,1450,3427
860Z200US13071,ZCTA5 13071,857,216,71,145
860Z200US13072,ZCTA5 13072,819,111,29,82
860Z200US13073,ZCTA5 13073,6408,1553,559,994
860Z200US13074,ZCTA5 13074,4393,850,205,645
860Z200US13076,ZCTA5 13076,2416,556,86,470
860Z200US13077,ZCTA5 13077,6646,1342,218,1124
860Z200US13078,ZCTA5 13078,10335,2557,590,1967
860Z200US13080,ZCTA5 13080,3505,600,201,399
860Z200US13081,ZCTA5 13081,1114,218,50,168
860Z200US13082,ZCTA5 13082,3750,688,203,485
860Z200US13083,ZCTA5 13083,1979,340,85,255
860Z200US13084,ZCTA5 13084,3801,729,141,588
860Z200US13087,ZCTA5 13087,161,11,0,11
860Z200US13088,ZCTA5 13088,21770,3628,888,2740
860Z200US13090,ZCTA5 13090,29181,6222,1523,4699
860Z200US13092,ZCTA5 13092,2718,812,160,652
860Z200US13101,ZCTA5 13101,2342,654,115,539
860Z200US13102,ZCTA5 13102,52,0,0,0
860Z200US13103,ZCTA5 13103,226,25,6,19
860Z200US13104,ZCTA5 13104,16708,3785,815,2970
860Z200US13108,ZCTA5 13108,6279,1171,155,1016
860Z200US13110,ZCTA5 13110,2375,407,115,292
860Z200US13111,ZCTA5 13111,1778,534,97,437
860Z200US13112,ZCTA5 13112,1728,391,90,301
860Z200US13113,ZCTA5 13113,52,2,0,2
860Z200US13114,ZCTA5 13114,7350,1517,307,1210
860Z200US13115,ZCTA5 13115,225,51,0,51
860Z200US13116,ZCTA5 13116,3574,695,112,583
860Z200US13117,ZCTA5 13117,279,63,3,60
860Z200US13118,ZCTA5 13118,5035,1058,180,878
860Z200US13119,ZCTA5 13119,0,0,0,0
860Z200US13120,ZCTA5 13120,2212,412,126,286
860Z200US13121,ZCTA5 13121,0,0,0,0
860Z200US13122,ZCTA5 13122,982,134,30,104
860Z200US13123,ZCTA5 13123,32,0,0,0
860Z200US13124,ZCTA5 13124,102,16,2,14
860Z200US13126,ZCTA5 13126,31716,6671,1555,5116
860Z200US13131,ZCTA5 13131,3115,555,168,387
860Z200US13132,ZCTA5 13132,3495,691,126,565
860Z200US13134,ZCTA5 13134,132,1,0,1
860Z200US13135,ZCTA5 13135,6234,1494,489,1005
860Z200US13136,ZCTA5 13136,329,105,24,81
860Z200US13138,ZCTA5 13138,139,23,0,23
860Z200US13140,ZCTA5 13140,4327,868,134,734
860Z200US13141,ZCTA5 13141,649,132,63,69
860Z200US13142,ZCTA5 13142,6004,1137,213,924
860Z200US13143,ZCTA5 13143,2299,639,181,458
860Z200US13144,ZCTA5 13144,1314,369,98,271
860Z200US13145,ZCTA5 13145,1588,340,118,222
860Z200US13146,ZCTA5 13146,2163,528,125,403
860Z200US13147,ZCTA5 13147,929,163,58,105
860Z200US13148,ZCTA5 13148,10683,1901,511,1390
860Z200US13152,ZCTA5 13152,7618,1506,392,1114
860Z200US13153,ZCTA5 13153,337,154,45,109
860Z200US13154,ZCTA5 13154,34,0,0,0
860Z200US13155,ZCTA5 13155,567,118,22,96
860Z200US13156,ZCTA5 13156,2154,260,91,169
860Z200US13157,ZCTA5 13157,535,88,24,64
860Z200US13158,ZCTA5 13158,1352,169,51,118
860Z200US13159,ZCTA5 13159,5217,1096,250,846
860Z200US13160,ZCTA5 13160,2205,534,99,435
860Z200US13162,ZCTA5 13162,409,126,39,87
860Z200US13163,ZCTA5 13163,263,44,7,37
860Z200US13164,ZCTA5 13164,2711,945,206,739
860Z200US13165,ZCTA5 13165,9282,1867,585,1282
860Z200US13166,ZCTA5 13166,5737,1077,232,845
860Z200US13167,ZCTA5 13167,2982,691,127,564
860Z200US13202,ZCTA5 13202,6579,1580,574,1006
860Z200US13203,ZCTA5 13203,16104,3360,745,2615
860Z200US13204,ZCTA5 13204,19476,5097,1278,3819
860Z200US13205,ZCTA5 13205,17098,4526,1246,3280
860Z200US13206,ZCTA5 13206,16580,3158,1053,2105
860Z200US13207,ZCTA5 13207,12774,3207,1127,2080
860Z200US13208,ZCTA5 13208,23072,6495,1813,4682
860Z200US13209,ZCTA5 13209,13170,2461,917,1544
860Z200US13210,ZCTA5 13210,16188,2025,884,1141
860Z200US13211,ZCTA5 13211,5955,1291,306,985
860Z200US13212,ZCTA5 13212,20562,3642,791,2851
860Z200US13214,ZCTA5 13214,7456,1773,456,1317
860Z200US13215,ZCTA5 13215,13314,2713,761,1952
860Z200US13219,ZCTA5 13219,15309,3117,916,2201
860Z200US13224,ZCTA5 13224,8694,1948,482,1466
860Z200US13244,ZCTA5 13244,10,0,0,0
860Z200US13290,ZCTA5 13290,0,0,0,0
860Z200US13301,ZCTA5 13301,156,32,8,24
860Z200US13302,ZCTA5 13302,1375,296,116,180
860Z200US13303,ZCTA5 13303,1294,208,33,175
860Z200US13304,ZCTA5 13304,1919,527,173,354
860Z200US13305,ZCTA5 13305,198,0,0,0
860Z200US13308,ZCTA5 13308,4405,931,140,791
860Z200US13309,ZCTA5 13309,5696,1063,243,820
860Z200US13310,ZCTA5 13310,837,160,40,120
860Z200US13312,ZCTA5 13312,308,30,11,19
860Z200US13313,ZCTA5 13313,597,116,23,93
860Z200US13314,ZCTA5 13314,153,63,0,63
860Z200US13315,ZCTA5 13315,1399,297,78,219
860Z200US13316,ZCTA5 13316,5825,1183,296,887
860Z200US13317,ZCTA5 13317,3965,1279,293,986
860Z200US13318,ZCTA5 13318,1043,216,63,153
860Z200US13319,ZCTA5 13319,550,15,0,15
860Z200US13320,ZCTA5 13320,2080,376,131,245
860Z200US13321,ZCTA5 13321,776,136,0,136
860Z200US13322,ZCTA5 13322,1073,227,58,169
860Z200US13323,ZCTA5 13323,9168,1376,356,1020
860Z200US13324,ZCTA5 13324,1629,219,51,168
860Z200US13325,ZCTA5 13325,929,198,76,122
860Z200US13326,ZCTA5 13326,4365,501,110,391
860Z200US13327,ZCTA5 13327,2230,624,128,496
860Z200US13328,ZCTA5 13328,1451,290,62,228
860Z200US13329,ZCTA5 13329,3548,751,152,599
860Z200US13331,ZCTA5 13331,69,0,0,0
860Z200US13332,ZCTA5 13332,2878,972,377,595
860Z200US13333,ZCTA5 13333,57,2,0,2
860Z200US13334,ZCTA5 13334,943,152,60,92
860Z200US13335,ZCTA5 13335,1319,281,127,154
860Z200US13337,ZCTA5 13337,653,73,3,70
860Z200US13338,ZCTA5 13338,1239,238,17,221
860Z200US13339,ZCTA5 13339,6037,1516,497,1019
860Z200US13340,ZCTA5 13340,7456,1644,369,1275
860Z200US13342,ZCTA5 13342,275,105,49,56
860Z200US13343,ZCTA5 13343,1616,300,67,233
860Z200US13345,ZCTA5 13345,175,36,24,12
860Z200US13346,ZCTA5 13346,3850,737,185,552
860Z200US13348,ZCTA5 13348,1669,309,73,236
860Z200US13350,ZCTA5 13350,9140,1268,285,983
860Z200US13352,ZCTA5 13352,29,24,0,24
860Z200US13353,ZCTA5 13353,41,7,2,5
860Z200US13354,ZCTA5 13354,3285,806,276,530
860Z200US13355,ZCTA5 13355,1139,204,116,88
860Z200US13357,ZCTA5 13357,10100,2155,424,1731
860Z200US13360,ZCTA5 13360,128,16,0,16
860Z200US13361,ZCTA5 13361,661,99,44,55
860Z200US13363,ZCTA5 13363,2401,607,180,427
860Z200US13364,ZCTA5 13364,232,16,0,16
860Z200US13365,ZCTA5 13365,8355,2235,573,1662
860Z200US13367,ZCTA5 13367,8503,1701,452,1249
860Z200US13368,ZCTA5 13368,1102,250,93,157
860Z200US13402,ZCTA5 13402,1082,183,40,143
860Z200US13403,ZCTA5 13403,4800,1182,558,624
860Z200US13404,ZCTA5 13404,127,41,7,34
860Z200US13406,ZCTA5 13406,485,124,26,98
860Z200US13407,ZCTA5 13407,5095,1129,211,918
860Z200US13408,ZCTA5 13408,1868,419,96,323
860Z200US13409,ZCTA5 13409,1976,263,50,213
860Z200US13410,ZCTA5 13410,536,59,16,43
860Z200US13411,ZCTA5 13411,2678,500,157,343
860Z200US13413,ZCTA5 13413,15361,2885,507,2378
860Z200US13415,ZCTA5 13415,82,3,0,3
860Z200US13416,ZCTA5 13416,2235,497,138,359
860Z200US13417,ZCTA5 13417,3103,344,80,264
860Z200US13418,ZCTA5 13418,212,3,3,0
860Z200US13420,ZCTA5 13420,1092,46,22,24
860Z200US13421,ZCTA5 13421,12729,2615,689,1926
860Z200US13424,ZCTA5 13424,1914,392,132,260
860Z200US13425,ZCTA5 13425,1762,335,96,239
860Z200US13428,ZCTA5 13428,1472,251,60,191
860Z200US13431,ZCTA5 13431,1934,488,95,393
860Z200US13433,ZCTA5 13433,1647,541,143,398
860Z200US13435,ZCTA5 13435,240,91,13,78
860Z200US13436,ZCTA5 13436,88,5,3,2
860Z200US13437,ZCTA5 13437,307,42,21,21
860Z200US13438,ZCTA5 13438,2979,549,139,410
860Z200US13439,ZCTA5 13439,3715,832,244,588
860Z200US13440,ZCTA5 13440,39305,8301,2211,6090
860Z200US13441,ZCTA5 13441,197,0,0,0
860Z200US13450,ZCTA5 13450,218,6,2,4
860Z200US13452,ZCTA5 13452,4767,1068,283,785
860Z200US13454,ZCTA5 13454,718,81,36,45
860Z200US13455,ZCTA5 13455,46,27,2,25
860Z200US13456,ZCTA5 13456,3977,1114,255,859
860Z200US13457,ZCTA5 13457,32,2,0,2
860Z200US13459,ZCTA5 13459,2045,457,108,349
860Z200US13460,ZCTA5 13460,4293,1017,191,826
860Z200US13461,ZCTA5 13461,3147,644,205,439
860Z200US13464,ZCTA5 13464,1225,250,41,209
860Z200US13468,ZCTA5 13468,291,51,13,38
860Z200US13469,ZCTA5 13469,1317,241,18,223
860Z200US13470,ZCTA5 13470,710,135,38,97
860Z200US13471,ZCTA5 13471,2610,598,173,425
860Z200US13472,ZCTA5 13472,340,134,96,38
860Z200US13473,ZCTA5 13473,1123,296,73,223
860Z200US13475,ZCTA5 13475,39,3,3,0
860Z200US13476,ZCTA5 13476,2972,618,189,429
860Z200US13477,ZCTA5 13477,1478,380,68,312
860Z200US13478,ZCTA5 13478,3040,462,162,300
860Z200US13480,ZCTA5 13480,3346,796,139,657
860Z200US13482,ZCTA5 13482,63,8,0,8
860Z200US13483,ZCTA5 13483,439,83,26,57
860Z200US13484,ZCTA5 13484,29,0,0,0
860Z200US13485,ZCTA5 13485,1628,464,103,361
860Z200US13486,ZCTA5 13486,731,149,72,77
860Z200US13488,ZCTA5 13488,141,6,0,6
860Z200US13489,ZCTA5 13489,533,94,10,84
860Z200US13490,ZCTA5 13490,1181,313,131,182
860Z200US13491,ZCTA5 13491,3813,823,217,606
860Z200US13492,ZCTA5 13492,11329,2218,443,1775
860Z200US13493,ZCTA5 13493,2199,636,225,411
860Z200US13494,ZCTA5 13494,222,32,16,16
860Z200US13495,ZCTA5 13495,2004,455,143,312
860Z200US13501,ZCTA5 13501,39184,10651,2646,8005
860Z200US13502,ZCTA5 13502,32643,7375,2240,5135
860Z200US13601,ZCTA5 13601,37087,8268,2392,5876
860Z200US13602,ZCTA5 13602,0,0,0,0
860Z200US13603,ZCTA5 13603,13972,5541,2733,2808
860Z200US13605,ZCTA5 13605,5242,1491,199,1292
860Z200US13606,ZCTA5 13606,2373,477,120,357
860Z200US13607,ZCTA5 13607,1730,208,41,167
860Z200US13608,ZCTA5 13608,1818,424,117,307
860Z200US13611,ZCTA5 13611,312,100,29,71
860Z200US13612,ZCTA5 13612,2703,516,94,422
860Z200US13613,ZCTA5 13613,2593,516,147,369
860Z200US13614,ZCTA5 13614,345,86,23,63
860Z200US13615,ZCTA5 13615,582,60,12,48
860Z200US13616,ZCTA5 13616,1936,168,53,115
860Z200US13617,ZCTA5 13617,8780,1631,431,1200
860Z200US13618,ZCTA5 13618,1782,352,99,253
860Z200US13619,ZCTA5 13619,10443,2464,611,1853
860Z200US13620,ZCTA5 13620,2066,648,209,439
860Z200US13621,ZCTA5 13621,578,169,92,77
860Z200US13622,ZCTA5 13622,1962,489,96,393
860Z200US13623,ZCTA5 13623,51,4,4,0
860Z200US13624,ZCTA5 13624,4328,628,222,406
860Z200US13625,ZCTA5 13625,1551,270,58,212
860Z200US13626,ZCTA5 13626,2282,474,127,347
860Z200US13628,ZCTA5 13628,268,110,47,63
860Z200US13630,ZCTA5 13630,1428,309,27,282
860Z200US13632,ZCTA5 13632,107,0,0,0
860Z200US13633,ZCTA5 13633,318,117,22,95
860Z200US13634,ZCTA5 13634,3919,906,150,756
860Z200US13635,ZCTA5 13635,1227,362,81,281
860Z200US13636,ZCTA5 13636,177,76,17,59
860Z200US13637,ZCTA5 13637,4358,991,469,522
860Z200US13638,ZCTA5 13638,372,124,0,124
860Z200US13639,ZCTA5 13639,24,0,0,0
860Z200US13640,ZCTA5 13640,292,20,10,10
860Z200US13641,ZCTA5 13641,54,0,0,0
860Z200US13642,ZCTA5 13642,8307,1417,494,923
860Z200US13643,ZCTA5 13643,60,36,27,9
860Z200US13645,ZCTA5 13645,0,0,0,0
860Z200US13646,ZCTA5 13646,2242,468,100,368
860Z200US13647,ZCTA5 13647,150,19,0,19
860Z200US13648,ZCTA5 13648,1978,392,50,342
860Z200US13649,ZCTA5 13649,37,7,0,7
860Z200US13650,ZCTA5 13650,1345,247,65,182
860Z200US13651,ZCTA5 13651,126,4,0,4
860Z200US13652,ZCTA5 13652,1726,470,141,329
860Z200US13654,ZCTA5 13654,2363,604,127,477
860Z200US13655,ZCTA5 13655,3660,875,205,670
860Z200US13656,ZCTA5 13656,3224,1071,236,835
860Z200US13658,ZCTA5 13658,2273,446,74,372
860Z200US13659,ZCTA5 13659,374,68,18,50
860Z200US13660,ZCTA5 13660,1822,500,134,366
860Z200US13661,ZCTA5 13661,1768,440,77,363
860Z200US13662,ZCTA5 13662,15644,2897,527,2370
860Z200US13664,ZCTA5 13664,404,50,12,38
860Z200US13665,ZCTA5 13665,812,158,26,132
860Z200US13666,ZCTA5 13666,216,68,0,68
860Z200US13667,ZCTA5 13667,3171,708,128,580
860Z200US13668,ZCTA5 13668,3186,734,199,535
860Z200US13669,ZCTA5 13669,14357,3637,797,2840
860Z200US13670,ZCTA5 13670,383,58,22,36
860Z200US13672,ZCTA5 13672,376,76,6,70
860Z200US13673,ZCTA5 13673,1973,477,117,360
860Z200US13674,ZCTA5 13674,137,50,4,46
860Z200US13675,ZCTA5 13675,61,28,0,28
860Z200US13676,ZCTA5 13676,12143,2429,655,1774
860Z200US13678,ZCTA5 13678,105,0,0,0
860Z200US13679,ZCTA5 13679,1081,209,92,117
860Z200US13680,ZCTA5 13680,1380,439,101,338
860Z200US13681,ZCTA5 13681,971,279,66,213
860Z200US13682,ZCTA5 13682,845,144,23,121
860Z200US13683,ZCTA5 13683,66,17,0,17
860Z200US13684,ZCTA5 13684,1172,304,121,183
860Z200US13685,ZCTA5 13685,2184,299,68,231
860Z200US13687,ZCTA5 13687,499,71,44,27
860Z200US13690,ZCTA5 13690,768,187,60,127
860Z200US13691,ZCTA5 13691,3048,631,196,435
860Z200US13692,ZCTA5 13692,216,20,0,20
860Z200US13693,ZCTA5 13693,294,16,6,10
860Z200US13694,ZCTA5 13694,1253,209,86,123
860Z200US13695,ZCTA5 13695,146,18,0,18
860Z200US13696,ZCTA5 13696,174,0,0,0
860Z200US13697,ZCTA5 13697,1879,322,59,263
860Z200US13699,ZCTA5 13699,0,0,0,0
860Z200US13730,ZCTA5 13730,2864,462,122,340
860Z200US13731,ZCTA5 13731,1002,114,50,64
860Z200US13732,ZCTA5 13732,7599,1571,386,1185
860Z200US13733,ZCTA5 13733,5018,871,184,687
860Z200US13734,ZCTA5 13734,2303,309,127,182
860Z200US13736,ZCTA5 13736,1805,385,76,309
860Z200US13738,ZCTA5 13738,44,14,0,14
860Z200US13739,ZCTA5 13739,792,59,24,35
860Z200US13740,ZCTA5 13740,560,108,11,97
860Z200US13743,ZCTA5 13743,3394,607,93,514
860Z200US13744,ZCTA5 13744,1358,370,140,230
860Z200US13746,ZCTA5 13746,2134,318,73,245
860Z200US13747,ZCTA5 13747,29,0,0,0
860Z200US13748,ZCTA5 13748,3760,609,217,392
860Z200US13750,ZCTA5 13750,711,88,34,54
860Z200US13751,ZCTA5 13751,209,98,58,40
860Z200US13752,ZCTA5 13752,868,143,37,106
860Z200US13753,ZCTA5 13753,4008,675,167,508
860Z200US13754,ZCTA5 13754,2654,532,104,428
860Z200US13755,ZCTA5 13755,888,128,20,108
860Z200US13756,ZCTA5 13756,683,92,31,61
860Z200US13757,ZCTA5 13757,1263,181,8,173
860Z200US13760,ZCTA5 13760,42720,8760,2236,6524
860Z200US13774,ZCTA5 13774,148,8,5,3
860Z200US13775,ZCTA5 13775,1800,241,53,188
860Z200US13776,ZCTA5 13776,404,42,0,42
860Z200US13777,ZCTA5 13777,396,86,0,86
860Z200US13778,ZCTA5 13778,5279,1100,334,766
860Z200US13780,ZCTA5 13780,862,283,20,263
860Z200US13782,ZCTA5 13782,730,80,13,67
860Z200US13783,ZCTA5 13783,2318,306,18,288
860Z200US13784,ZCTA5 13784,294,62,21,41
860Z200US13786,ZCTA5 13786,363,68,14,54
860Z200US13787,ZCTA5 13787,3067,645,131,514
860Z200US13788,ZCTA5 13788,959,121,15,106
860Z200US13790,ZCTA5 13790,18172,3594,1065,2529
860Z200US13795,ZCTA5 13795,2953,481,89,392
860Z200US13796,ZCTA5 13796,986,140,55,85
860Z200US13797,ZCTA5 13797,2061,539,79,460
860Z200US13801,ZCTA5 13801,1488,200,48,152
860Z200US13802,ZCTA5 13802,1079,317,39,278
860Z200US13803,ZCTA5 13803,4238,1237,358,879
860Z200US13804,ZCTA5 13804,181,32,12,20
860Z200US13806,ZCTA5 13806,222,51,20,31
860Z200US13807,ZCTA5 13807,1296,215,32,183
860Z200US13808,ZCTA5 13808,1368,279,41,238
860Z200US13809,ZCTA5 13809,1964,405,185,220
860Z200US13810,ZCTA5 13810,1237,142,33,109
860Z200US13811,ZCTA5 13811,4120,954,302,652
860Z200US13812,ZCTA5 13812,2293,520,52,468
860Z200US13813,ZCTA5 13813,1131,538,0,538
860Z200US13814,ZCTA5 13814,18,7,0,7
860Z200US13815,ZCTA5 13815,12476,2427,664,1763
860Z200US13820,ZCTA5 13820,17880,2534,564,1970
860Z200US13825,ZCTA5 13825,3058,433,145,288
860Z200US13826,ZCTA5 13826,91,0,0,0
860Z200US13827,ZCTA5 13827,11431,2303,589,1714
860Z200US13830,ZCTA5 13830,4809,950,145,805
860Z200US13832,ZCTA5 13832,449,88,29,59
860Z200US13833,ZCTA5 13833,4145,1247,408,839
860Z200US13834,ZCTA5 13834,118,0,0,0
860Z200US13835,ZCTA5 13835,1301,270,48,222
860Z200US13838,ZCTA5 13838,3964,918,254,664
860Z200US13839,ZCTA5 13839,1317,353,65,288
860Z200US13841,ZCTA5 13841,483,150,43,107
860Z200US13842,ZCTA5 13842,569,29,1,28
860Z200US13843,ZCTA5 13843,2077,464,152,312
860Z200US13844,ZCTA5 13844,588,105,39,66
860Z200US13846,ZCTA5 13846,369,55,26,29
860Z200US13847,ZCTA5 13847,17,3,0,3
860Z200US13849,ZCTA5 13849,4405,661,212,449
860Z200US13850,ZCTA5 13850,23209,4329,1076,3253
860Z200US13856,ZCTA5 13856,5998,1094,298,796
860Z200US13859,ZCTA5 13859,101,28,0,28
860Z200US13860,ZCTA5 13860,228,57,7,50
860Z200US13861,ZCTA5 13861,454,58,0,58
860Z200US13862,ZCTA5 13862,3683,719,87,632
860Z200US13863,ZCTA5 13863,473,88,18,70
860Z200US13864,ZCTA5 13864,1148,152,118,34
860Z200US13865,ZCTA5 13865,5990,1202,387,815
860Z200US13901,ZCTA5 13901,19791,4052,1220,2832
860Z200US13902,ZCTA5 13902,0,0,0,0
860Z200US13903,ZCTA5 13903,18462,3696,924,2772
860Z200US13904,ZCTA5 13904,9151,2132,349,1783
860Z200US13905,ZCTA5 13905,26370,3482,1080,2402
860Z200US14001,ZCTA5 14001,9199,1829,247,1582
860Z200US14004,ZCTA5 14004,10484,2326,715,1611
860Z200US14005,ZCTA5 14005,2030,420,83,337
860Z200US14006,ZCTA5 14006,9367,1896,457,1439
860Z200US14008,ZCTA5 14008,1594,403,60,343
860Z200US14009,ZCTA5 14009,5441,1059,242,817
860Z200US14011,ZCTA5 14011,5599,1336,392,944
860Z200US14012,ZCTA5 14012,3015,734,162,572
860Z200US14013,ZCTA5 14013,1611,278,65,213
860Z200US14020,ZCTA5 14020,21851,4168,913,3255
860Z200US14024,ZCTA5 14024,1628,500,89,411
860Z200US14025,ZCTA5 14025,3687,508,114,394
860Z200US14026,ZCTA5 14026,506,65,65,0
860Z200US14027,ZCTA5 14027,34,0,0,0
860Z200US14028,ZCTA5 14028,1553,273,45,228
860Z200US14029,ZCTA5 14029,31,3,0,3
860Z200US14030,ZCTA5 14030,2040,531,219,312
860Z200US14031,ZCTA5 14031,9479,1597,179,1418
860Z200US14032,ZCTA5 14032,10490,2568,538,2030
860Z200US14033,ZCTA5 14033,1460,252,98,154
860Z200US14034,ZCTA5 14034,1960,356,69,287
860Z200US14035,ZCTA5 14035,61,17,0,17
860Z200US14036,ZCTA5 14036,5406,799,289,510
860Z200US14037,ZCTA5 14037,963,122,12,110
860Z200US14039,ZCTA5 14039,70,11,4,7
860Z200US14040,ZCTA5 14040,1791,436,128,308
860Z200US14041,ZCTA5 14041,132,17,0,17
860Z200US14042,ZCTA5 14042,4353,930,243,687
860Z200US14043,ZCTA5 14043,24910,4499,1129,3370
860Z200US14047,ZCTA5 14047,6147,759,282,477
860Z200US14048,ZCTA5 14048,14711,2473,665,1808
860Z200US14051,ZCTA5 14051,19747,4359,1083,3276
860Z200US14052,ZCTA5 14052,17209,2882,607,2275
860Z200US14054,ZCTA5 14054,1356,362,65,297
860Z200US14055,ZCTA5 14055,1455,198,31,167
860Z200US14056,ZCTA5 14056,194,59,0,59
860Z200US14057,ZCTA5 14057,7540,1528,373,1155
860Z200US14058,ZCTA5 14058,2408,767,258,509
860Z200US14059,ZCTA5 14059,9629,2245,699,1546
860Z200US14060,ZCTA5 14060,356,35,2,33
860Z200US14061,ZCTA5 14061,93,11,0,11
860Z200US14062,ZCTA5 14062,3251,762,181,581
860Z200US14063,ZCTA5 14063,11168,1710,440,1270
860Z200US14065,ZCTA5 14065,1728,432,79,353
860Z200US14066,ZCTA5 14066,1078,181,30,151
860Z200US14067,ZCTA5 14067,3963,807,154,653
860Z200US14068,ZCTA5 14068,7600,1812,421,1391
860Z200US14069,ZCTA5 14069,630,132,61,71
860Z200US14070,ZCTA5 14070,5975,1560,469,1091
860Z200US14072,ZCTA5 14072,21323,4232,1181,3051
860Z200US14075,ZCTA5 14075,44124,8287,1747,6540
860Z200US14080,ZCTA5 14080,4207,864,254,610
860Z200US14081,ZCTA5 14081,2764,519,74,445
860Z200US14082,ZCTA5 14082,671,219,17,202
860Z200US14083,ZCTA5 14083,10,0,0,0
860Z200US14085,ZCTA5 14085,8196,2114,381,1733
860Z200US14086,ZCTA5 14086,34860,6788,1763,5025
860Z200US14091,ZCTA5 14091,1600,465,102,363
860Z200US14092,ZCTA5 14092,10296,1782,319,1463
860Z200US14094,ZCTA5 14094,49564,10071,2557,7514
860Z200US14098,ZCTA5 14098,3143,814,261,553
860Z200US14101,ZCTA5 14101,1744,375,77,298
860Z200US14102,ZCTA5 14102,1488,291,13,278
860Z200US14103,ZCTA5 14103,10547,2208,559,1649
860Z200US14105,ZCTA5 14105,5120,1047,359,688
860Z200US14108,ZCTA5 14108,5131,1179,456,723
860Z200US14109,ZCTA5 14109,0,0,0,0
860Z200US14111,ZCTA5 14111,3121,690,109,581
860Z200US14112,ZCTA5 14112,54,0,0,0
860Z200US14113,ZCTA5 14113,686,132,49,83
860Z200US14120,ZCTA5 14120,43999,8039,2415,5624
860Z200US14125,ZCTA5 14125,3580,736,147,589
860Z200US14126,ZCTA5 14126,456,82,0,82
860Z200US14127,ZCTA5 14127,30299,6068,1657,4411
860Z200US14129,ZCTA5 14129,1300,269,44,225
860Z200US14130,ZCTA5 14130,105,37,0,37
860Z200US14131,ZCTA5 14131,5137,832,206,626
860Z200US14132,ZCTA5 14132,6576,1451,183,1268
860Z200US14134,ZCTA5 14134,72,18,6,12
860Z200US14135,ZCTA5 14135,122,0,0,0
860Z200US14136,ZCTA5 14136,5107,917,234,683
860Z200US14138,ZCTA5 14138,1845,387,83,304
860Z200US14139,ZCTA5 14139,2053,715,134,581
860Z200US14141,ZCTA5 14141,7367,1560,397,1163
860Z200US14143,ZCTA5 14143,1043,238,49,189
860Z200US14145,ZCTA5 14145,1156,143,82,61
860Z200US14150,ZCTA5 14150,41279,6907,1672,5235
860Z200US14166,ZCTA5 14166,231,0,0,0
860Z200US14167,ZCTA5 14167,1863,346,129,217
860Z200US14168,ZCTA5 14168,77,8,0,8
860Z200US14169,ZCTA5 14169,80,0,0,0
860Z200US14170,ZCTA5 14170,2212,503,80,423
860Z200US14171,ZCTA5 14171,1605,223,75,148
860Z200US14172,ZCTA5 14172,3087,594,126,468
860Z200US14173,ZCTA5 14173,188,71,0,71
860Z200US14174,ZCTA5 14174,5698,1176,285,891
860Z200US14201,ZCTA5 14201,12217,2907,741,2166
860Z200US14202,ZCTA5 14202,3315,436,143,293
860Z200US14203,ZCTA5 14203,2384,206,64,142
860Z200US14204,ZCTA5 14204,7662,1378,469,909
860Z200US14206,ZCTA5 14206,21601,4374,898,3476
860Z200US14207,ZCTA5 14207,25682,7539,1603,5936
860Z200US14208,ZCTA5 14208,10527,2138,701,1437
860Z200US14209,ZCTA5 14209,7626,855,262,593
860Z200US14210,ZCTA5 14210,15333,2919,775,2144
860Z200US14211,ZCTA5 14211,24022,7300,1783,5517
860Z200US14212,ZCTA5 14212,13244,3846,1075,2771
860Z200US14213,ZCTA5 14213,23346,6365,1794,4571
860Z200US14214,ZCTA5 14214,20693,3848,1111,2737
860Z200US14215,ZCTA5 14215,40968,10544,2991,7553
860Z200US14216,ZCTA5 14216,23930,3754,1573,2181
860Z200US14217,ZCTA5 14217,22608,3974,841,3133
860Z200US14218,ZCTA5 14218,20793,4479,1643,2836
860Z200US14219,ZCTA5 14219,10854,1594,338,1256
860Z200US14220,ZCTA5 14220,23815,4861,1340,3521
860Z200US14221,ZCTA5 14221,54121,10452,2998,7454
860Z200US14222,ZCTA5 14222,13839,1940,928,1012
860Z200US14223,ZCTA5 14223,22413,4168,1204,2964
860Z200US14224,ZCTA5 14224,40448,7199,1941,5258
860Z200US14225,ZCTA5 14225,33762,6160,1423,4737
860Z200US14226,ZCTA5 14226,28529,5953,1486,4467
860Z200US14227,ZCTA5 14227,20993,3124,1058,2066
860Z200US14228,ZCTA5 14228,24681,4791,1235,3556
860Z200US14260,ZCTA5 14260,0,0,0,0
860Z200US14261,ZCTA5 14261,0,0,0,0
860Z200US14301,ZCTA5 14301,11973,2299,665,1634
860Z200US14302,ZCTA5 14302,111,0,0,0
860Z200US14303,ZCTA5 14303,6117,1684,483,1201
860Z200US14304,ZCTA5 14304,28403,5327,1236,4091
860Z200US14305,ZCTA5 14305,16386,3454,876,2578
860Z200US14411,ZCTA5 14411,10869,1921,272,1649
860Z200US14413,ZCTA5 14413,174,41,0,41
860Z200US14414,ZCTA5 14414,6741,1386,296,1090
860Z200US14415,ZCTA5 14415,127,37,7,30
860Z200US14416,ZCTA5 14416,3785,744,220,524
860Z200US14418,ZCTA5 14418,1103,241,96,145
860Z200US14420,ZCTA5 14420,17292,3228,861,2367
860Z200US14422,ZCTA5 14422,1763,420,140,280
860Z200US14423,ZCTA5 14423,4896,975,276,699
860Z200US14424,ZCTA5 14424,27904,4807,984,3823
860Z200US14425,ZCTA5 14425,13000,3050,905,2145
860Z200US14427,ZCTA5 14427,1710,313,76,237
860Z200US14428,ZCTA5 14428,7297,1487,522,965
860Z200US14432,ZCTA5 14432,5371,1440,289,1151
860Z200US14433,ZCTA5 14433,4265,1170,415,755
860Z200US14435,ZCTA5 14435,2292,353,71,282
860Z200US14437,ZCTA5 14437,9160,1636,299,1337
860Z200US14441,ZCTA5 14441,431,109,15,94
860Z200US14445,ZCTA5 14445,7628,1225,264,961
860Z200US14450,ZCTA5 14450,42668,8987,2178,6809
860Z200US14453,ZCTA5 14453,0,0,0,0
860Z200US14454,ZCTA5 14454,7886,1277,374,903
860Z200US14456,ZCTA5 14456,17563,3389,1107,2282
860Z200US14462,ZCTA5 14462,803,219,49,170
860Z200US14463,ZCTA5 14463,302,64,14,50
860Z200US14464,ZCTA5 14464,6610,1342,516,826
860Z200US14466,ZCTA5 14466,1697,245,55,190
860Z200US14467,ZCTA5 14467,10359,2012,502,1510
860Z200US14468,ZCTA5 14468,18866,4679,1019,3660
860Z200US14469,ZCTA5 14469,5923,1034,236,798
860Z200US14470,ZCTA5 14470,7647,1510,446,1064
860Z200US14471,ZCTA5 14471,2721,298,36,262
860Z200US14472,ZCTA5 14472,9127,2245,560,1685
860Z200US14475,ZCTA5 14475,298,45,0,45
860Z200US14476,ZCTA5 14476,2461,612,161,451
860Z200US14477,ZCTA5 14477,1672,220,73,147
860Z200US14478,ZCTA5 14478,614,97,46,51
860Z200US14479,ZCTA5 14479,98,11,0,11
860Z200US14480,ZCTA5 14480,588,11,0,11
860Z200US14481,ZCTA5 14481,1772,381,66,315
860Z200US14482,ZCTA5 14482,8240,1622,458,1164
860Z200US14485,ZCTA5 14485,3868,791,239,552
860Z200US14486,ZCTA5 14486,255,57,14,43
860Z200US14487,ZCTA5 14487,5606,1166,291,875
860Z200US14489,ZCTA5 14489,6789,1454,430,1024
860Z200US14502,ZCTA5 14502,10090,2168,491,1677
860Z200US14504,ZCTA5 14504,1525,315,110,205
860Z200US14505,ZCTA5 14505,4833,909,204,705
860Z200US14506,ZCTA5 14506,692,102,30,72
860Z200US14507,ZCTA5 14507,1050,140,42,98
860Z200US14510,ZCTA5 14510,4552,939,268,671
860Z200US14511,ZCTA5 14511,385,101,0,101
860Z200US14512,ZCTA5 14512,4843,854,151,703
860Z200US14513,ZCTA5 14513,13580,2781,724,2057
860Z200US14514,ZCTA5 14514,5877,1169,285,884
860Z200US14515,ZCTA5 14515,138,0,0,0
860Z200US14516,ZCTA5 14516,2499,628,185,443
860Z200US14517,ZCTA5 14517,2739,552,123,429
860Z200US14519,ZCTA5 14519,12478,2848,585,2263
860Z200US14521,ZCTA5 14521,2875,723,211,512
860Z200US14522,ZCTA5 14522,9575,1624,432,1192
860Z200US14525,ZCTA5 14525,2486,500,143,357
860Z200US14526,ZCTA5 14526,19456,4339,1270,3069
860Z200US14527,ZCTA5 14527,12559,2736,801,1935
860Z200US14529,ZCTA5 14529,48,0,0,0
860Z200US14530,ZCTA5 14530,6284,1662,229,1433
860Z200US14532,ZCTA5 14532,3836,919,284,635
860Z200US14533,ZCTA5 14533,1818,360,103,257
860Z200US14534,ZCTA5 14534,33687,8146,1981,6165
860Z200US14536,ZCTA5 14536,643,101,29,72
860Z200US14537,ZCTA5 14537,117,0,0,0
860Z200US14539,ZCTA5 14539,187,38,0,38
860Z200US14541,ZCTA5 14541,2483,725,196,529
860Z200US14542,ZCTA5 14542,0,0,0,0
860Z200US14543,ZCTA5 14543,3133,458,45,413
860Z200US14544,ZCTA5 14544,2157,521,68,453
860Z200US14545,ZCTA5 14545,108,18,9,9
860Z200US14546,ZCTA5 14546,4901,750,344,406
860Z200US14548,ZCTA5 14548,4022,610,131,479
860Z200US14549,ZCTA5 14549,390,72,59,13
860Z200US14550,ZCTA5 14550,1223,281,47,234
860Z200US14551,ZCTA5 14551,4860,667,176,491
860Z200US14555,ZCTA5 14555,1203,152,67,85
860Z200US14556,ZCTA5 14556,19,0,0,0
860Z200US14557,ZCTA5 14557,121,11,6,5
860Z200US14559,ZCTA5 14559,18351,3858,845,3013
860Z200US14560,ZCTA5 14560,2150,320,57,263
860Z200US14561,ZCTA5 14561,2373,427,52,375
860Z200US14564,ZCTA5 14564,15990,3675,842,2833
860Z200US14568,ZCTA5 14568,6349,1413,213,1200
860Z200US14569,ZCTA5 14569,6260,848,189,659
860Z200US14571,ZCTA5 14571,1306,112,58,54
860Z200US14572,ZCTA5 14572,4838,1249,201,1048
860Z200US14580,ZCTA5 14580,54107,10957,2362,8595
860Z200US14585,ZCTA5 14585,156,4,4,0
860Z200US14586,ZCTA5 14586,12565,2519,386,2133
860Z200US14588,ZCTA5 14588,0,0,0,0
860Z200US14589,ZCTA5 14589,7829,1728,562,1166
860Z200US14590,ZCTA5 14590,5059,992,108,884
860Z200US14591,ZCTA5 14591,1561,276,134,142
860Z200US14592,ZCTA5 14592,113,10,0,10
860Z200US14604,ZCTA5 14604,2671,91,55,36
860Z200US14605,ZCTA5 14605,10991,3268,1021,2247
860Z200US14606,ZCTA5 14606,27579,6406,1713,4693
860Z200US14607,ZCTA5 14607,16777,931,377,554
860Z200US14608,ZCTA5 14608,12352,2751,726,2025
860Z200US14609,ZCTA5 14609,40954,8593,2467,6126
860Z200US14610,ZCTA5 14610,13804,1955,428,1527
860Z200US14611,ZCTA5 14611,17398,4862,1460,3402
860Z200US14612,ZCTA5 14612,34714,6646,1360,5286
860Z200US14613,ZCTA5 14613,14868,4680,1056,3624
860Z200US14614,ZCTA5 14614,308,23,19,4
860Z200US14615,ZCTA5 14615,18380,4766,1501,3265
860Z200US14616,ZCTA5 14616,27080,6736,1569,5167
860Z200US14617,ZCTA5 14617,21915,4636,880,3756
860Z200US14618,ZCTA5 14618,20838,4945,831,4114
860Z200US14619,ZCTA5 14619,13989,3307,1072,2235
860Z200US14620,ZCTA5 14620,22374,2193,726,1467
860Z200US14621,ZCTA5 14621,32183,8702,2544,6158
860Z200US14622,ZCTA5 14622,12729,2264,661,1603
860Z200US14623,ZCTA5 14623,19655,2600,759,1841
860Z200US14624,ZCTA5 14624,38197,7981,2319,5662
860Z200US14625,ZCTA5 14625,10381,1646,359,1287
860Z200US14626,ZCTA5 14626,29008,5009,1519,3490
860Z200US14627,ZCTA5 14627,0,0,0,0
860Z200US14642,ZCTA5 14642,0,0,0,0
860Z200US14701,ZCTA5 14701,38677,8709,2643,6066
860Z200US14706,ZCTA5 14706,6031,1213,286,927
860Z200US14707,ZCTA5 14707,93,18,7,11
860Z200US14708,ZCTA5 14708,155,29,9,20
860Z200US14709,ZCTA5 14709,1240,243,56,187
860Z200US14710,ZCTA5 14710,3095,703,103,600
860Z200US14711,ZCTA5 14711,1932,466,87,379
860Z200US14712,ZCTA5 14712,3007,434,113,321
860Z200US14714,ZCTA5 14714,544,139,46,93
860Z200US14715,ZCTA5 14715,2576,493,140,353
860Z200US14716,ZCTA5 14716,1971,528,219,309
860Z200US14717,ZCTA5 14717,561,52,16,36
860Z200US14718,ZCTA5 14718,1857,428,88,340
860Z200US14719,ZCTA5 14719,3365,660,146,514
860Z200US14720,ZCTA5 14720,845,216,34,182
860Z200US14721,ZCTA5 14721,175,13,0,13
860Z200US14722,ZCTA5 14722,99,2,0,2
860Z200US14723,ZCTA5 14723,1012,193,54,139
860Z200US14724,ZCTA5 14724,2944,1123,234,889
860Z200US14726,ZCTA5 14726,2743,1321,433,888
860Z200US14727,ZCTA5 14727,4866,1104,246,858
860Z200US14728,ZCTA5 14728,1049,246,54,192
860Z200US14729,ZCTA5 14729,808,159,38,121
860Z200US14731,ZCTA5 14731,1215,166,63,103
860Z200US14732,ZCTA5 14732,18,5,0,5
860Z200US14733,ZCTA5 14733,3093,550,93,457
860Z200US14735,ZCTA5 14735,2698,785,179,606
860Z200US14736,ZCTA5 14736,154,11,8,3
860Z200US14737,ZCTA5 14737,4105,928,264,664
860Z200US14738,ZCTA5 14738,3476,584,114,470
860Z200US14739,ZCTA5 14739,2615,616,145,471
860Z200US14740,ZCTA5 14740,997,194,33,161
860Z200US14741,ZCTA5 14741,1883,473,77,396
860Z200US14742,ZCTA5 14742,90,0,0,0
860Z200US14743,ZCTA5 14743,2157,442,94,348
860Z200US14744,ZCTA5 14744,1474,436,123,313
860Z200US14747,ZCTA5 14747,2053,470,140,330
860Z200US14748,ZCTA5 14748,505,96,15,81
860Z200US14750,ZCTA5 14750,4521,883,190,693
860Z200US14752,ZCTA5 14752,230,64,0,64
860Z200US14753,ZCTA5 14753,942,188,39,149
860Z200US14754,ZCTA5 14754,534,92,41,51
860Z200US14755,ZCTA5 14755,2753,561,122,439
860Z200US14756,ZCTA5 14756,0,0,0,0
860Z200US14757,ZCTA5 14757,2839,441,127,314
860Z200US14760,ZCTA5 14760,17476,3842,956,2886
860Z200US14767,ZCTA5 14767,2265,609,101,508
860Z200US14769,ZCTA5 14769,651,36,10,26
860Z200US14770,ZCTA5 14770,2872,685,137,548
860Z200US14772,ZCTA5 14772,3953,886,256,630
860Z200US14774,ZCTA5 14774,236,46,4,42
860Z200US14775,ZCTA5 14775,2560,670,146,524
860Z200US14777,ZCTA5 14777,601,167,24,143
860Z200US14778,ZCTA5 14778,15,0,0,0
860Z200US14779,ZCTA5 14779,6775,1599,398,1201
860Z200US14781,ZCTA5 14781,1774,382,79,303
860Z200US14782,ZCTA5 14782,2169,383,94,289
860Z200US14783,ZCTA5 14783,122,20,0,20
860Z200US14784,ZCTA5 14784,750,80,23,57
860Z200US14785,ZCTA5 14785,130,0,0,0
860Z200US14787,ZCTA5 14787,4664,967,149,818
860Z200US14788,ZCTA5 14788,99,0,0,0
860Z200US14801,ZCTA5 14801,5216,1474,378,1096
860Z200US14802,ZCTA5 14802,1197,114,21,93
860Z200US14803,ZCTA5 14803,1546,398,116,282
860Z200US14804,ZCTA5 14804,1486,346,52,294
860Z200US14805,ZCTA5 14805,761,87,27,60
860Z200US14806,ZCTA5 14806,2149,488,127,361
860Z200US14807,ZCTA5 14807,3020,772,240,532
860Z200US14808,ZCTA5 14808,550,146,31,115
860Z200US14809,ZCTA5 14809,2880,782,229,553
860Z200US14810,ZCTA5 14810,10984,1773,488,1285
860Z200US14812,ZCTA5 14812,3249,606,104,502
860Z200US14813,ZCTA5 14813,2055,416,85,331
860Z200US14814,ZCTA5 14814,1784,454,103,351
860Z200US14815,ZCTA5 14815,708,130,34,96
860Z200US14816,ZCTA5 14816,595,111,23,88
860Z200US14817,ZCTA5 14817,2900,780,281,499
860Z200US14818,ZCTA5 14818,1765,176,14,162
860Z200US14819,ZCTA5 14819,598,175,38,137
860Z200US14820,ZCTA5 14820,531,105,38,67
860Z200US14821,ZCTA5 14821,3297,754,126,628
860Z200US14822,ZCTA5 14822,850,169,52,117
860Z200US14823,ZCTA5 14823,3851,814,151,663
860Z200US14824,ZCTA5 14824,766,170,61,109
860Z200US14825,ZCTA5 14825,755,159,13,146
860Z200US14826,ZCTA5 14826,1923,441,102,339
860Z200US14827,ZCTA5 14827,16,0,0,0
860Z200US14830,ZCTA5 14830,18953,3922,975,2947
860Z200US14836,ZCTA5 14836,835,84,20,64
860Z200US14837,ZCTA5 14837,5432,1270,279,991
860Z200US14838,ZCTA5 14838,2037,370,68,302
860Z200US14839,ZCTA5 14839,594,105,30,75
860Z200US14840,ZCTA5 14840,2567,319,69,250
860Z200US14841,ZCTA5 14841,743,159,52,107
860Z200US14842,ZCTA5 14842,847,237,151,86
860Z200US14843,ZCTA5 14843,12189,2307,597,1710
860Z200US14845,ZCTA5 14845,20454,3998,1244,2754
860Z200US14846,ZCTA5 14846,912,232,42,190
860Z200US14847,ZCTA5 14847,2356,492,120,372
860Z200US14850,ZCTA5 14850,55053,7012,1626,5386
860Z200US14853,ZCTA5 14853,0,0,0,0
860Z200US14854,ZCTA5 14854,95,0,0,0
860Z200US14855,ZCTA5 14855,853,272,105,167
860Z200US14856,ZCTA5 14856,0,0,0,0
860Z200US14858,ZCTA5 14858,1391,313,88,225
860Z200US14859,ZCTA5 14859,1141,272,65,207
860Z200US14860,ZCTA5 14860,1117,237,89,148
860Z200US14861,ZCTA5 14861,1138,148,17,131
860Z200US14864,ZCTA5 14864,1033,265,100,165
860Z200US14865,ZCTA5 14865,2591,530,145,385
860Z200US14867,ZCTA5 14867,5234,1079,262,817
860Z200US14869,ZCTA5 14869,1471,347,136,211
860Z200US14870,ZCTA5 14870,9858,2217,702,1515
860Z200US14871,ZCTA5 14871,4453,843,316,527
860Z200US14872,ZCTA5 14872,542,113,14,99
860Z200US14873,ZCTA5 14873,1968,461,123,338
860Z200US14874,ZCTA5 14874,155,51,9,42
860Z200US14877,ZCTA5 14877,684,125,36,89
860Z200US14878,ZCTA5 14878,856,316,57,259
860Z200US14879,ZCTA5 14879,2250,461,117,344
860Z200US14880,ZCTA5 14880,1514,187,47,140
860Z200US14881,ZCTA5 14881,250,14,14,0
860Z200US14882,ZCTA5 14882,3647,877,120,757
860Z200US14883,ZCTA5 14883,4500,1066,291,775
860Z200US14884,ZCTA5 14884,303,81,40,41
860Z200US14885,ZCTA5 14885,587,141,7,134
860Z200US14886,ZCTA5 14886,6544,1235,231,1004
860Z200US14889,ZCTA5 14889,1267,314,96,218
860Z200US14891,ZCTA5 14891,4391,704,212,492
860Z200US14892,ZCTA5 14892,7350,1470,348,1122
860Z200US14893,ZCTA5 14893,34,21,0,21
860Z200US14894,ZCTA5 14894,1196,267,79,188
860Z200US14895,ZCTA5 14895,8918,1509,481,1028
860Z200US14897,ZCTA5 14897,716,166,50,116
860Z200US14898,ZCTA5 14898,1546,362,116,246
860Z200US14901,ZCTA5 14901,12101,2988,548,2440
860Z200US14903,ZCTA5 14903,7043,1433,396,1037
860Z200US14904,ZCTA5 14904,14267,3068,588,2480
860Z200US14905,ZCTA5 14905,8754,1915,489,1426
